"";"comuna_name";"edad";"hombres";"mujeres";"total"
"1";"Algarrobo";"20-24";357;360;717
"2";"Algarrobo";"25-29";419;412;831
"3";"Algarrobo";"30-34";446;359;805
"4";"Algarrobo";"35-39";343;327;670
"5";"Algarrobo";"40-44";352;337;689
"6";"Algarrobo";"45-49";350;297;647
"7";"Algarrobo";"50-54";369;351;720
"8";"Algarrobo";"55-59";341;305;646
"9";"Algarrobo";"60-64";247;275;522
"10";"Algarrobo";"65-69";236;244;480
"11";"Algarrobo";"70-74";147;153;300
"12";"Algarrobo";"75-80";235;261;496
"13";"Alhué";"20-24";200;186;386
"14";"Alhué";"25-29";195;174;369
"15";"Alhué";"30-34";234;201;435
"16";"Alhué";"35-39";233;188;421
"17";"Alhué";"40-44";229;186;415
"18";"Alhué";"45-49";219;157;376
"19";"Alhué";"50-54";177;133;310
"20";"Alhué";"55-59";165;122;287
"21";"Alhué";"60-64";139;126;265
"22";"Alhué";"65-69";132;106;238
"23";"Alhué";"70-74";98;74;172
"24";"Alhué";"75-80";117;133;250
"25";"Alto Biobío";"20-24";350;327;677
"26";"Alto Biobío";"25-29";337;285;622
"27";"Alto Biobío";"30-34";279;230;509
"28";"Alto Biobío";"35-39";275;165;440
"29";"Alto Biobío";"40-44";323;170;493
"30";"Alto Biobío";"45-49";267;144;411
"31";"Alto Biobío";"50-54";224;166;390
"32";"Alto Biobío";"55-59";174;135;309
"33";"Alto Biobío";"60-64";115;99;214
"34";"Alto Biobío";"65-69";81;81;162
"35";"Alto Biobío";"70-74";36;45;81
"36";"Alto Biobío";"75-80";61;79;140
"37";"Alto del Carmen";"20-24";246;197;443
"38";"Alto del Carmen";"25-29";220;173;393
"39";"Alto del Carmen";"30-34";231;177;408
"40";"Alto del Carmen";"35-39";205;146;351
"41";"Alto del Carmen";"40-44";237;132;369
"42";"Alto del Carmen";"45-49";247;180;427
"43";"Alto del Carmen";"50-54";232;154;386
"44";"Alto del Carmen";"55-59";232;192;424
"45";"Alto del Carmen";"60-64";239;162;401
"46";"Alto del Carmen";"65-69";187;129;316
"47";"Alto del Carmen";"70-74";125;103;228
"48";"Alto del Carmen";"75-80";205;183;388
"49";"Alto Hospicio";"20-24";3513;3806;7319
"50";"Alto Hospicio";"25-29";4213;4297;8510
"51";"Alto Hospicio";"30-34";4453;4675;9128
"52";"Alto Hospicio";"35-39";4358;4332;8690
"53";"Alto Hospicio";"40-44";3675;3316;6991
"54";"Alto Hospicio";"45-49";2892;2661;5553
"55";"Alto Hospicio";"50-54";2526;2185;4711
"56";"Alto Hospicio";"55-59";1869;1757;3626
"57";"Alto Hospicio";"60-64";1277;1165;2442
"58";"Alto Hospicio";"65-69";732;704;1436
"59";"Alto Hospicio";"70-74";419;412;831
"60";"Alto Hospicio";"75-80";345;536;881
"61";"Ancud";"20-24";1702;1582;3284
"62";"Ancud";"25-29";1456;1607;3063
"63";"Ancud";"30-34";1388;1425;2813
"64";"Ancud";"35-39";1617;1610;3227
"65";"Ancud";"40-44";1649;1716;3365
"66";"Ancud";"45-49";1633;1675;3308
"67";"Ancud";"50-54";1432;1434;2866
"68";"Ancud";"55-59";1249;1200;2449
"69";"Ancud";"60-64";915;942;1857
"70";"Ancud";"65-69";704;736;1440
"71";"Ancud";"70-74";529;623;1152
"72";"Ancud";"75-80";664;970;1634
"73";"Andacollo";"20-24";426;396;822
"74";"Andacollo";"25-29";367;412;779
"75";"Andacollo";"30-34";376;408;784
"76";"Andacollo";"35-39";401;399;800
"77";"Andacollo";"40-44";387;386;773
"78";"Andacollo";"45-49";392;350;742
"79";"Andacollo";"50-54";309;393;702
"80";"Andacollo";"55-59";337;325;662
"81";"Andacollo";"60-64";287;277;564
"82";"Andacollo";"65-69";210;226;436
"83";"Andacollo";"70-74";155;171;326
"84";"Andacollo";"75-80";288;320;608
"85";"Angol";"20-24";2063;2204;4267
"86";"Angol";"25-29";1934;2083;4017
"87";"Angol";"30-34";1618;1824;3442
"88";"Angol";"35-39";1666;1861;3527
"89";"Angol";"40-44";1903;2090;3993
"90";"Angol";"45-49";1932;2122;4054
"91";"Angol";"50-54";1788;1842;3630
"92";"Angol";"55-59";1404;1486;2890
"93";"Angol";"60-64";1168;1204;2372
"94";"Angol";"65-69";948;1018;1966
"95";"Angol";"70-74";707;909;1616
"96";"Angol";"75-80";882;1499;2381
"97";"Antártica";"20-24";3;2;5
"98";"Antártica";"25-29";26;9;35
"99";"Antártica";"30-34";20;0;20
"100";"Antártica";"35-39";35;3;38
"101";"Antártica";"40-44";22;2;24
"102";"Antártica";"45-49";28;0;28
"103";"Antártica";"50-54";11;0;11
"104";"Antártica";"55-59";2;0;2
"105";"Antártica";"60-64";4;0;4
"106";"Antártica";"65-69";0;0;0
"107";"Antártica";"70-74";0;0;0
"108";"Antártica";"75-80";0;0;0
"109";"Antofagasta";"20-24";16736;15258;31994
"110";"Antofagasta";"25-29";17635;14374;32009
"111";"Antofagasta";"30-34";15697;13162;28859
"112";"Antofagasta";"35-39";15105;12735;27840
"113";"Antofagasta";"40-44";14532;11812;26344
"114";"Antofagasta";"45-49";13580;11363;24943
"115";"Antofagasta";"50-54";12340;11322;23662
"116";"Antofagasta";"55-59";10180;9282;19462
"117";"Antofagasta";"60-64";7547;7209;14756
"118";"Antofagasta";"65-69";5073;5381;10454
"119";"Antofagasta";"70-74";3174;4028;7202
"120";"Antofagasta";"75-80";3618;6385;10003
"121";"Antuco";"20-24";156;150;306
"122";"Antuco";"25-29";121;117;238
"123";"Antuco";"30-34";109;108;217
"124";"Antuco";"35-39";122;133;255
"125";"Antuco";"40-44";116;142;258
"126";"Antuco";"45-49";124;135;259
"127";"Antuco";"50-54";101;142;243
"128";"Antuco";"55-59";142;104;246
"129";"Antuco";"60-64";122;121;243
"130";"Antuco";"65-69";101;78;179
"131";"Antuco";"70-74";85;77;162
"132";"Antuco";"75-80";109;102;211
"133";"Arauco";"20-24";1801;1646;3447
"134";"Arauco";"25-29";1639;1692;3331
"135";"Arauco";"30-34";1354;1430;2784
"136";"Arauco";"35-39";1298;1252;2550
"137";"Arauco";"40-44";1268;1312;2580
"138";"Arauco";"45-49";1348;1287;2635
"139";"Arauco";"50-54";1145;1148;2293
"140";"Arauco";"55-59";1003;844;1847
"141";"Arauco";"60-64";782;703;1485
"142";"Arauco";"65-69";527;594;1121
"143";"Arauco";"70-74";393;450;843
"144";"Arauco";"75-80";642;824;1466
"145";"Arica";"20-24";10001;9289;19290
"146";"Arica";"25-29";11022;9291;20313
"147";"Arica";"30-34";8642;8272;16914
"148";"Arica";"35-39";7728;7856;15584
"149";"Arica";"40-44";7759;7835;15594
"150";"Arica";"45-49";7100;7785;14885
"151";"Arica";"50-54";6559;6992;13551
"152";"Arica";"55-59";6278;5885;12163
"153";"Arica";"60-64";4724;4881;9605
"154";"Arica";"65-69";3745;4016;7761
"155";"Arica";"70-74";2550;2898;5448
"156";"Arica";"75-80";3128;4467;7595
"157";"Aysén";"20-24";1220;1124;2344
"158";"Aysén";"25-29";1234;900;2134
"159";"Aysén";"30-34";980;893;1873
"160";"Aysén";"35-39";1102;1075;2177
"161";"Aysén";"40-44";1100;976;2076
"162";"Aysén";"45-49";983;779;1762
"163";"Aysén";"50-54";986;768;1754
"164";"Aysén";"55-59";767;586;1353
"165";"Aysén";"60-64";552;490;1042
"166";"Aysén";"65-69";367;312;679
"167";"Aysén";"70-74";243;268;511
"168";"Aysén";"75-80";327;441;768
"169";"Buín";"20-24";3486;3459;6945
"170";"Buín";"25-29";3350;3307;6657
"171";"Buín";"30-34";3282;3240;6522
"172";"Buín";"35-39";3141;3002;6143
"173";"Buín";"40-44";2947;2743;5690
"174";"Buín";"45-49";2684;2613;5297
"175";"Buín";"50-54";2414;2503;4917
"176";"Buín";"55-59";1912;1981;3893
"177";"Buín";"60-64";1599;1550;3149
"178";"Buín";"65-69";1200;1178;2378
"179";"Buín";"70-74";825;910;1735
"180";"Buín";"75-80";1071;1574;2645
"181";"Bulnes";"20-24";876;822;1698
"182";"Bulnes";"25-29";797;831;1628
"183";"Bulnes";"30-34";682;720;1402
"184";"Bulnes";"35-39";711;691;1402
"185";"Bulnes";"40-44";790;788;1578
"186";"Bulnes";"45-49";758;748;1506
"187";"Bulnes";"50-54";805;748;1553
"188";"Bulnes";"55-59";588;650;1238
"189";"Bulnes";"60-64";533;518;1051
"190";"Bulnes";"65-69";394;430;824
"191";"Bulnes";"70-74";291;326;617
"192";"Bulnes";"75-80";486;579;1065
"193";"Cabildo";"20-24";820;770;1590
"194";"Cabildo";"25-29";802;878;1680
"195";"Cabildo";"30-34";782;793;1575
"196";"Cabildo";"35-39";699;661;1360
"197";"Cabildo";"40-44";640;669;1309
"198";"Cabildo";"45-49";659;629;1288
"199";"Cabildo";"50-54";696;618;1314
"200";"Cabildo";"55-59";526;460;986
"201";"Cabildo";"60-64";469;379;848
"202";"Cabildo";"65-69";326;315;641
"203";"Cabildo";"70-74";214;222;436
"204";"Cabildo";"75-80";308;413;721
"205";"Cabo de Hornos";"20-24";165;78;243
"206";"Cabo de Hornos";"25-29";290;115;405
"207";"Cabo de Hornos";"30-34";234;119;353
"208";"Cabo de Hornos";"35-39";214;93;307
"209";"Cabo de Hornos";"40-44";125;62;187
"210";"Cabo de Hornos";"45-49";83;43;126
"211";"Cabo de Hornos";"50-54";81;33;114
"212";"Cabo de Hornos";"55-59";87;19;106
"213";"Cabo de Hornos";"60-64";33;19;52
"214";"Cabo de Hornos";"65-69";22;8;30
"215";"Cabo de Hornos";"70-74";5;8;13
"216";"Cabo de Hornos";"75-80";4;4;8
"217";"Cabrero";"20-24";1202;1224;2426
"218";"Cabrero";"25-29";1207;1185;2392
"219";"Cabrero";"30-34";1073;1066;2139
"220";"Cabrero";"35-39";1036;944;1980
"221";"Cabrero";"40-44";996;884;1880
"222";"Cabrero";"45-49";1027;929;1956
"223";"Cabrero";"50-54";937;869;1806
"224";"Cabrero";"55-59";763;788;1551
"225";"Cabrero";"60-64";635;657;1292
"226";"Cabrero";"65-69";509;469;978
"227";"Cabrero";"70-74";380;399;779
"228";"Cabrero";"75-80";492;581;1073
"229";"Calama";"20-24";6565;6210;12775
"230";"Calama";"25-29";7697;6913;14610
"231";"Calama";"30-34";7169;6600;13769
"232";"Calama";"35-39";7068;6798;13866
"233";"Calama";"40-44";6698;5969;12667
"234";"Calama";"45-49";6438;5538;11976
"235";"Calama";"50-54";6013;5018;11031
"236";"Calama";"55-59";4808;4009;8817
"237";"Calama";"60-64";2999;2646;5645
"238";"Calama";"65-69";1932;1804;3736
"239";"Calama";"70-74";1097;1170;2267
"240";"Calama";"75-80";1338;1678;3016
"241";"Calbuco";"20-24";1310;1227;2537
"242";"Calbuco";"25-29";1237;1199;2436
"243";"Calbuco";"30-34";1284;1131;2415
"244";"Calbuco";"35-39";1261;1164;2425
"245";"Calbuco";"40-44";1260;1095;2355
"246";"Calbuco";"45-49";1217;1072;2289
"247";"Calbuco";"50-54";1123;1049;2172
"248";"Calbuco";"55-59";954;930;1884
"249";"Calbuco";"60-64";721;731;1452
"250";"Calbuco";"65-69";588;589;1177
"251";"Calbuco";"70-74";504;524;1028
"252";"Calbuco";"75-80";701;994;1695
"253";"Caldera";"20-24";764;622;1386
"254";"Caldera";"25-29";586;628;1214
"255";"Caldera";"30-34";614;512;1126
"256";"Caldera";"35-39";642;545;1187
"257";"Caldera";"40-44";695;588;1283
"258";"Caldera";"45-49";696;556;1252
"259";"Caldera";"50-54";555;503;1058
"260";"Caldera";"55-59";415;393;808
"261";"Caldera";"60-64";331;275;606
"262";"Caldera";"65-69";292;243;535
"263";"Caldera";"70-74";180;179;359
"264";"Caldera";"75-80";200;222;422
"265";"Calera  de Tango";"20-24";940;891;1831
"266";"Calera  de Tango";"25-29";963;935;1898
"267";"Calera  de Tango";"30-34";912;969;1881
"268";"Calera  de Tango";"35-39";966;981;1947
"269";"Calera  de Tango";"40-44";908;891;1799
"270";"Calera  de Tango";"45-49";886;798;1684
"271";"Calera  de Tango";"50-54";800;660;1460
"272";"Calera  de Tango";"55-59";610;521;1131
"273";"Calera  de Tango";"60-64";426;418;844
"274";"Calera  de Tango";"65-69";337;300;637
"275";"Calera  de Tango";"70-74";243;230;473
"276";"Calera  de Tango";"75-80";249;319;568
"277";"Calle Larga";"20-24";545;501;1046
"278";"Calle Larga";"25-29";515;543;1058
"279";"Calle Larga";"30-34";498;540;1038
"280";"Calle Larga";"35-39";481;461;942
"281";"Calle Larga";"40-44";439;471;910
"282";"Calle Larga";"45-49";481;430;911
"283";"Calle Larga";"50-54";467;460;927
"284";"Calle Larga";"55-59";417;348;765
"285";"Calle Larga";"60-64";324;304;628
"286";"Calle Larga";"65-69";267;225;492
"287";"Calle Larga";"70-74";141;188;329
"288";"Calle Larga";"75-80";268;352;620
"289";"Camarones";"20-24";37;17;54
"290";"Camarones";"25-29";48;19;67
"291";"Camarones";"30-34";45;12;57
"292";"Camarones";"35-39";36;21;57
"293";"Camarones";"40-44";33;19;52
"294";"Camarones";"45-49";28;24;52
"295";"Camarones";"50-54";35;24;59
"296";"Camarones";"55-59";29;22;51
"297";"Camarones";"60-64";23;11;34
"298";"Camarones";"65-69";18;17;35
"299";"Camarones";"70-74";18;9;27
"300";"Camarones";"75-80";19;15;34
"301";"Camiña";"20-24";31;41;72
"302";"Camiña";"25-29";54;51;105
"303";"Camiña";"30-34";42;48;90
"304";"Camiña";"35-39";39;35;74
"305";"Camiña";"40-44";46;28;74
"306";"Camiña";"45-49";44;27;71
"307";"Camiña";"50-54";37;29;66
"308";"Camiña";"55-59";51;29;80
"309";"Camiña";"60-64";41;33;74
"310";"Camiña";"65-69";37;29;66
"311";"Camiña";"70-74";33;13;46
"312";"Camiña";"75-80";19;18;37
"313";"Canela";"20-24";327;326;653
"314";"Canela";"25-29";322;323;645
"315";"Canela";"30-34";280;269;549
"316";"Canela";"35-39";335;272;607
"317";"Canela";"40-44";369;347;716
"318";"Canela";"45-49";356;298;654
"319";"Canela";"50-54";355;314;669
"320";"Canela";"55-59";285;271;556
"321";"Canela";"60-64";302;286;588
"322";"Canela";"65-69";242;270;512
"323";"Canela";"70-74";223;191;414
"324";"Canela";"75-80";296;335;631
"325";"Cañete";"20-24";1338;1405;2743
"326";"Cañete";"25-29";1256;1335;2591
"327";"Cañete";"30-34";1085;1159;2244
"328";"Cañete";"35-39";1006;1067;2073
"329";"Cañete";"40-44";1121;1104;2225
"330";"Cañete";"45-49";1237;1192;2429
"331";"Cañete";"50-54";1127;1082;2209
"332";"Cañete";"55-59";996;939;1935
"333";"Cañete";"60-64";683;689;1372
"334";"Cañete";"65-69";624;630;1254
"335";"Cañete";"70-74";459;416;875
"336";"Cañete";"75-80";623;779;1402
"337";"Carahue";"20-24";1072;1044;2116
"338";"Carahue";"25-29";995;927;1922
"339";"Carahue";"30-34";810;786;1596
"340";"Carahue";"35-39";834;745;1579
"341";"Carahue";"40-44";926;832;1758
"342";"Carahue";"45-49";928;870;1798
"343";"Carahue";"50-54";973;800;1773
"344";"Carahue";"55-59";756;709;1465
"345";"Carahue";"60-64";629;568;1197
"346";"Carahue";"65-69";453;519;972
"347";"Carahue";"70-74";373;397;770
"348";"Carahue";"75-80";574;766;1340
"349";"Cartagena";"20-24";692;727;1419
"350";"Cartagena";"25-29";714;709;1423
"351";"Cartagena";"30-34";727;662;1389
"352";"Cartagena";"35-39";602;625;1227
"353";"Cartagena";"40-44";621;620;1241
"354";"Cartagena";"45-49";688;713;1401
"355";"Cartagena";"50-54";658;726;1384
"356";"Cartagena";"55-59";599;606;1205
"357";"Cartagena";"60-64";532;577;1109
"358";"Cartagena";"65-69";397;520;917
"359";"Cartagena";"70-74";334;348;682
"360";"Cartagena";"75-80";433;649;1082
"361";"Casablanca";"20-24";1147;1116;2263
"362";"Casablanca";"25-29";1419;1229;2648
"363";"Casablanca";"30-34";1240;1094;2334
"364";"Casablanca";"35-39";961;905;1866
"365";"Casablanca";"40-44";953;842;1795
"366";"Casablanca";"45-49";843;834;1677
"367";"Casablanca";"50-54";866;868;1734
"368";"Casablanca";"55-59";673;684;1357
"369";"Casablanca";"60-64";610;550;1160
"370";"Casablanca";"65-69";509;492;1001
"371";"Casablanca";"70-74";353;338;691
"372";"Casablanca";"75-80";517;602;1119
"373";"Castro";"20-24";1980;2161;4141
"374";"Castro";"25-29";1768;1902;3670
"375";"Castro";"30-34";1578;1642;3220
"376";"Castro";"35-39";1684;1808;3492
"377";"Castro";"40-44";1673;1719;3392
"378";"Castro";"45-49";1589;1752;3341
"379";"Castro";"50-54";1420;1512;2932
"380";"Castro";"55-59";1122;1240;2362
"381";"Castro";"60-64";868;998;1866
"382";"Castro";"65-69";657;880;1537
"383";"Castro";"70-74";459;699;1158
"384";"Castro";"75-80";701;1378;2079
"385";"Catemu";"20-24";578;573;1151
"386";"Catemu";"25-29";557;600;1157
"387";"Catemu";"30-34";538;495;1033
"388";"Catemu";"35-39";428;421;849
"389";"Catemu";"40-44";417;403;820
"390";"Catemu";"45-49";444;457;901
"391";"Catemu";"50-54";491;442;933
"392";"Catemu";"55-59";411;343;754
"393";"Catemu";"60-64";331;334;665
"394";"Catemu";"65-69";275;215;490
"395";"Catemu";"70-74";182;161;343
"396";"Catemu";"75-80";257;314;571
"397";"Cauquenes";"20-24";1473;1498;2971
"398";"Cauquenes";"25-29";1283;1347;2630
"399";"Cauquenes";"30-34";1155;1210;2365
"400";"Cauquenes";"35-39";1232;1285;2517
"401";"Cauquenes";"40-44";1330;1451;2781
"402";"Cauquenes";"45-49";1472;1540;3012
"403";"Cauquenes";"50-54";1348;1542;2890
"404";"Cauquenes";"55-59";1192;1321;2513
"405";"Cauquenes";"60-64";1150;1175;2325
"406";"Cauquenes";"65-69";908;1002;1910
"407";"Cauquenes";"70-74";615;824;1439
"408";"Cauquenes";"75-80";1081;1529;2610
"409";"Cerrillos";"20-24";3542;3337;6879
"410";"Cerrillos";"25-29";3691;3476;7167
"411";"Cerrillos";"30-34";3272;3159;6431
"412";"Cerrillos";"35-39";2906;2841;5747
"413";"Cerrillos";"40-44";2662;2714;5376
"414";"Cerrillos";"45-49";2607;2863;5470
"415";"Cerrillos";"50-54";2761;3056;5817
"416";"Cerrillos";"55-59";2434;2857;5291
"417";"Cerrillos";"60-64";2050;2304;4354
"418";"Cerrillos";"65-69";1541;1682;3223
"419";"Cerrillos";"70-74";994;1230;2224
"420";"Cerrillos";"75-80";1126;1980;3106
"421";"Cerro Navia";"20-24";6764;6571;13335
"422";"Cerro Navia";"25-29";7265;7055;14320
"423";"Cerro Navia";"30-34";6705;6198;12903
"424";"Cerro Navia";"35-39";5561;5216;10777
"425";"Cerro Navia";"40-44";4838;4655;9493
"426";"Cerro Navia";"45-49";4660;4996;9656
"427";"Cerro Navia";"50-54";5161;5640;10801
"428";"Cerro Navia";"55-59";4590;4882;9472
"429";"Cerro Navia";"60-64";3629;3985;7614
"430";"Cerro Navia";"65-69";2473;2995;5468
"431";"Cerro Navia";"70-74";1601;2001;3602
"432";"Cerro Navia";"75-80";1676;2792;4468
"433";"Chaitén";"20-24";123;117;240
"434";"Chaitén";"25-29";131;133;264
"435";"Chaitén";"30-34";111;103;214
"436";"Chaitén";"35-39";110;123;233
"437";"Chaitén";"40-44";129;127;256
"438";"Chaitén";"45-49";145;156;301
"439";"Chaitén";"50-54";109;102;211
"440";"Chaitén";"55-59";84;100;184
"441";"Chaitén";"60-64";57;71;128
"442";"Chaitén";"65-69";50;50;100
"443";"Chaitén";"70-74";35;34;69
"444";"Chaitén";"75-80";38;58;96
"445";"Chanco";"20-24";412;373;785
"446";"Chanco";"25-29";286;315;601
"447";"Chanco";"30-34";271;276;547
"448";"Chanco";"35-39";315;303;618
"449";"Chanco";"40-44";348;308;656
"450";"Chanco";"45-49";353;295;648
"451";"Chanco";"50-54";282;293;575
"452";"Chanco";"55-59";294;272;566
"453";"Chanco";"60-64";243;232;475
"454";"Chanco";"65-69";199;204;403
"455";"Chanco";"70-74";159;154;313
"456";"Chanco";"75-80";187;235;422
"457";"Chañaral";"20-24";558;501;1059
"458";"Chañaral";"25-29";576;523;1099
"459";"Chañaral";"30-34";523;421;944
"460";"Chañaral";"35-39";483;416;899
"461";"Chañaral";"40-44";510;427;937
"462";"Chañaral";"45-49";481;430;911
"463";"Chañaral";"50-54";489;436;925
"464";"Chañaral";"55-59";420;405;825
"465";"Chañaral";"60-64";325;312;637
"466";"Chañaral";"65-69";275;202;477
"467";"Chañaral";"70-74";182;187;369
"468";"Chañaral";"75-80";200;236;436
"469";"Chépica";"20-24";695;639;1334
"470";"Chépica";"25-29";511;479;990
"471";"Chépica";"30-34";476;440;916
"472";"Chépica";"35-39";520;537;1057
"473";"Chépica";"40-44";574;544;1118
"474";"Chépica";"45-49";613;594;1207
"475";"Chépica";"50-54";579;552;1131
"476";"Chépica";"55-59";525;431;956
"477";"Chépica";"60-64";383;374;757
"478";"Chépica";"65-69";329;303;632
"479";"Chépica";"70-74";248;230;478
"480";"Chépica";"75-80";372;439;811
"481";"Chiguayante";"20-24";4213;4376;8589
"482";"Chiguayante";"25-29";3696;4028;7724
"483";"Chiguayante";"30-34";3249;3734;6983
"484";"Chiguayante";"35-39";3291;3596;6887
"485";"Chiguayante";"40-44";3352;3868;7220
"486";"Chiguayante";"45-49";3501;3805;7306
"487";"Chiguayante";"50-54";3169;3559;6728
"488";"Chiguayante";"55-59";2407;2728;5135
"489";"Chiguayante";"60-64";1800;2046;3846
"490";"Chiguayante";"65-69";1258;1415;2673
"491";"Chiguayante";"70-74";813;1168;1981
"492";"Chiguayante";"75-80";1147;2132;3279
"493";"Chile Chico";"20-24";157;171;328
"494";"Chile Chico";"25-29";173;138;311
"495";"Chile Chico";"30-34";179;159;338
"496";"Chile Chico";"35-39";192;161;353
"497";"Chile Chico";"40-44";219;169;388
"498";"Chile Chico";"45-49";253;172;425
"499";"Chile Chico";"50-54";197;161;358
"500";"Chile Chico";"55-59";167;145;312
"501";"Chile Chico";"60-64";131;104;235
"502";"Chile Chico";"65-69";106;91;197
"503";"Chile Chico";"70-74";69;65;134
"504";"Chile Chico";"75-80";103;93;196
"505";"Chillán";"20-24";7754;8535;16289
"506";"Chillán";"25-29";6999;7416;14415
"507";"Chillán";"30-34";5781;6274;12055
"508";"Chillán";"35-39";5492;6079;11571
"509";"Chillán";"40-44";5969;6845;12814
"510";"Chillán";"45-49";6342;6846;13188
"511";"Chillán";"50-54";5746;6340;12086
"512";"Chillán";"55-59";4788;5365;10153
"513";"Chillán";"60-64";3661;4237;7898
"514";"Chillán";"65-69";2714;3459;6173
"515";"Chillán";"70-74";1936;2701;4637
"516";"Chillán";"75-80";2535;4667;7202
"517";"Chillán Viejo";"20-24";1173;1218;2391
"518";"Chillán Viejo";"25-29";1249;1439;2688
"519";"Chillán Viejo";"30-34";1180;1295;2475
"520";"Chillán Viejo";"35-39";1010;1120;2130
"521";"Chillán Viejo";"40-44";1013;1009;2022
"522";"Chillán Viejo";"45-49";973;1066;2039
"523";"Chillán Viejo";"50-54";907;1001;1908
"524";"Chillán Viejo";"55-59";762;848;1610
"525";"Chillán Viejo";"60-64";632;625;1257
"526";"Chillán Viejo";"65-69";466;500;966
"527";"Chillán Viejo";"70-74";319;388;707
"528";"Chillán Viejo";"75-80";469;642;1111
"529";"Chimbarongo";"20-24";1556;1582;3138
"530";"Chimbarongo";"25-29";1339;1335;2674
"531";"Chimbarongo";"30-34";1142;1112;2254
"532";"Chimbarongo";"35-39";1427;1319;2746
"533";"Chimbarongo";"40-44";1389;1290;2679
"534";"Chimbarongo";"45-49";1265;1295;2560
"535";"Chimbarongo";"50-54";1304;1184;2488
"536";"Chimbarongo";"55-59";1122;961;2083
"537";"Chimbarongo";"60-64";898;789;1687
"538";"Chimbarongo";"65-69";662;610;1272
"539";"Chimbarongo";"70-74";485;499;984
"540";"Chimbarongo";"75-80";654;742;1396
"541";"Cholchol";"20-24";452;379;831
"542";"Cholchol";"25-29";354;340;694
"543";"Cholchol";"30-34";324;308;632
"544";"Cholchol";"35-39";327;286;613
"545";"Cholchol";"40-44";395;377;772
"546";"Cholchol";"45-49";393;347;740
"547";"Cholchol";"50-54";367;307;674
"548";"Cholchol";"55-59";359;272;631
"549";"Cholchol";"60-64";275;256;531
"550";"Cholchol";"65-69";235;250;485
"551";"Cholchol";"70-74";187;207;394
"552";"Cholchol";"75-80";246;327;573
"553";"Chonchi";"20-24";628;511;1139
"554";"Chonchi";"25-29";605;506;1111
"555";"Chonchi";"30-34";575;479;1054
"556";"Chonchi";"35-39";546;531;1077
"557";"Chonchi";"40-44";564;490;1054
"558";"Chonchi";"45-49";573;481;1054
"559";"Chonchi";"50-54";433;457;890
"560";"Chonchi";"55-59";422;388;810
"561";"Chonchi";"60-64";299;351;650
"562";"Chonchi";"65-69";233;298;531
"563";"Chonchi";"70-74";193;236;429
"564";"Chonchi";"75-80";246;412;658
"565";"Cisnes";"20-24";376;272;648
"566";"Cisnes";"25-29";313;190;503
"567";"Cisnes";"30-34";238;195;433
"568";"Cisnes";"35-39";266;205;471
"569";"Cisnes";"40-44";243;172;415
"570";"Cisnes";"45-49";202;179;381
"571";"Cisnes";"50-54";180;155;335
"572";"Cisnes";"55-59";142;92;234
"573";"Cisnes";"60-64";88;84;172
"574";"Cisnes";"65-69";70;47;117
"575";"Cisnes";"70-74";47;41;88
"576";"Cisnes";"75-80";48;53;101
"577";"Cobquecura";"20-24";205;173;378
"578";"Cobquecura";"25-29";189;174;363
"579";"Cobquecura";"30-34";179;164;343
"580";"Cobquecura";"35-39";181;148;329
"581";"Cobquecura";"40-44";254;208;462
"582";"Cobquecura";"45-49";252;182;434
"583";"Cobquecura";"50-54";256;185;441
"584";"Cobquecura";"55-59";232;168;400
"585";"Cobquecura";"60-64";167;183;350
"586";"Cobquecura";"65-69";153;126;279
"587";"Cobquecura";"70-74";103;106;209
"588";"Cobquecura";"75-80";200;208;408
"589";"Cochamó";"20-24";231;119;350
"590";"Cochamó";"25-29";190;105;295
"591";"Cochamó";"30-34";177;125;302
"592";"Cochamó";"35-39";179;136;315
"593";"Cochamó";"40-44";212;122;334
"594";"Cochamó";"45-49";203;146;349
"595";"Cochamó";"50-54";188;93;281
"596";"Cochamó";"55-59";138;107;245
"597";"Cochamó";"60-64";110;75;185
"598";"Cochamó";"65-69";90;81;171
"599";"Cochamó";"70-74";69;65;134
"600";"Cochamó";"75-80";90;114;204
"601";"Cochrane";"20-24";131;127;258
"602";"Cochrane";"25-29";124;107;231
"603";"Cochrane";"30-34";109;81;190
"604";"Cochrane";"35-39";123;94;217
"605";"Cochrane";"40-44";129;110;239
"606";"Cochrane";"45-49";154;129;283
"607";"Cochrane";"50-54";153;100;253
"608";"Cochrane";"55-59";103;90;193
"609";"Cochrane";"60-64";84;63;147
"610";"Cochrane";"65-69";51;43;94
"611";"Cochrane";"70-74";40;33;73
"612";"Cochrane";"75-80";66;48;114
"613";"Codegua";"20-24";690;629;1319
"614";"Codegua";"25-29";480;492;972
"615";"Codegua";"30-34";441;415;856
"616";"Codegua";"35-39";557;516;1073
"617";"Codegua";"40-44";537;515;1052
"618";"Codegua";"45-49";546;453;999
"619";"Codegua";"50-54";445;371;816
"620";"Codegua";"55-59";399;330;729
"621";"Codegua";"60-64";264;281;545
"622";"Codegua";"65-69";241;221;462
"623";"Codegua";"70-74";185;157;342
"624";"Codegua";"75-80";200;230;430
"625";"Coelemu";"20-24";653;636;1289
"626";"Coelemu";"25-29";623;619;1242
"627";"Coelemu";"30-34";554;511;1065
"628";"Coelemu";"35-39";562;564;1126
"629";"Coelemu";"40-44";659;626;1285
"630";"Coelemu";"45-49";642;622;1264
"631";"Coelemu";"50-54";618;604;1222
"632";"Coelemu";"55-59";492;511;1003
"633";"Coelemu";"60-64";424;406;830
"634";"Coelemu";"65-69";324;312;636
"635";"Coelemu";"70-74";221;300;521
"636";"Coelemu";"75-80";382;517;899
"637";"Coihueco";"20-24";1094;969;2063
"638";"Coihueco";"25-29";995;1038;2033
"639";"Coihueco";"30-34";889;895;1784
"640";"Coihueco";"35-39";847;791;1638
"641";"Coihueco";"40-44";902;849;1751
"642";"Coihueco";"45-49";885;808;1693
"643";"Coihueco";"50-54";908;694;1602
"644";"Coihueco";"55-59";693;629;1322
"645";"Coihueco";"60-64";607;531;1138
"646";"Coihueco";"65-69";493;471;964
"647";"Coihueco";"70-74";397;342;739
"648";"Coihueco";"75-80";537;564;1101
"649";"Coinco";"20-24";314;265;579
"650";"Coinco";"25-29";199;203;402
"651";"Coinco";"30-34";222;215;437
"652";"Coinco";"35-39";230;222;452
"653";"Coinco";"40-44";252;235;487
"654";"Coinco";"45-49";234;269;503
"655";"Coinco";"50-54";288;223;511
"656";"Coinco";"55-59";205;202;407
"657";"Coinco";"60-64";229;192;421
"658";"Coinco";"65-69";158;134;292
"659";"Coinco";"70-74";122;105;227
"660";"Coinco";"75-80";200;253;453
"661";"Colbún";"20-24";790;798;1588
"662";"Colbún";"25-29";687;713;1400
"663";"Colbún";"30-34";545;616;1161
"664";"Colbún";"35-39";608;607;1215
"665";"Colbún";"40-44";642;643;1285
"666";"Colbún";"45-49";686;724;1410
"667";"Colbún";"50-54";757;650;1407
"668";"Colbún";"55-59";587;545;1132
"669";"Colbún";"60-64";512;405;917
"670";"Colbún";"65-69";356;339;695
"671";"Colbún";"70-74";288;279;567
"672";"Colbún";"75-80";345;472;817
"673";"Colchane";"20-24";83;63;146
"674";"Colchane";"25-29";64;47;111
"675";"Colchane";"30-34";63;51;114
"676";"Colchane";"35-39";65;45;110
"677";"Colchane";"40-44";54;40;94
"678";"Colchane";"45-49";57;38;95
"679";"Colchane";"50-54";72;48;120
"680";"Colchane";"55-59";49;46;95
"681";"Colchane";"60-64";62;30;92
"682";"Colchane";"65-69";32;29;61
"683";"Colchane";"70-74";28;27;55
"684";"Colchane";"75-80";43;47;90
"685";"Colina";"20-24";5482;4602;10084
"686";"Colina";"25-29";5673;4722;10395
"687";"Colina";"30-34";5304;4648;9952
"688";"Colina";"35-39";5075;4389;9464
"689";"Colina";"40-44";4374;3731;8105
"690";"Colina";"45-49";4166;3590;7756
"691";"Colina";"50-54";3434;2851;6285
"692";"Colina";"55-59";2345;2319;4664
"693";"Colina";"60-64";1725;1585;3310
"694";"Colina";"65-69";1276;1256;2532
"695";"Colina";"70-74";827;768;1595
"696";"Colina";"75-80";889;1242;2131
"697";"Collipulli";"20-24";942;964;1906
"698";"Collipulli";"25-29";866;926;1792
"699";"Collipulli";"30-34";737;754;1491
"700";"Collipulli";"35-39";837;798;1635
"701";"Collipulli";"40-44";906;885;1791
"702";"Collipulli";"45-49";920;876;1796
"703";"Collipulli";"50-54";823;757;1580
"704";"Collipulli";"55-59";630;625;1255
"705";"Collipulli";"60-64";531;505;1036
"706";"Collipulli";"65-69";426;454;880
"707";"Collipulli";"70-74";335;342;677
"708";"Collipulli";"75-80";481;560;1041
"709";"Coltauco";"20-24";865;760;1625
"710";"Coltauco";"25-29";632;664;1296
"711";"Coltauco";"30-34";542;538;1080
"712";"Coltauco";"35-39";634;682;1316
"713";"Coltauco";"40-44";728;661;1389
"714";"Coltauco";"45-49";706;708;1414
"715";"Coltauco";"50-54";705;587;1292
"716";"Coltauco";"55-59";565;515;1080
"717";"Coltauco";"60-64";458;494;952
"718";"Coltauco";"65-69";436;373;809
"719";"Coltauco";"70-74";249;268;517
"720";"Coltauco";"75-80";419;531;950
"721";"Combarbalá";"20-24";559;545;1104
"722";"Combarbalá";"25-29";521;506;1027
"723";"Combarbalá";"30-34";485;427;912
"724";"Combarbalá";"35-39";468;461;929
"725";"Combarbalá";"40-44";467;487;954
"726";"Combarbalá";"45-49";537;518;1055
"727";"Combarbalá";"50-54";529;554;1083
"728";"Combarbalá";"55-59";455;422;877
"729";"Combarbalá";"60-64";451;468;919
"730";"Combarbalá";"65-69";356;396;752
"731";"Combarbalá";"70-74";315;316;631
"732";"Combarbalá";"75-80";436;633;1069
"733";"Concepción";"20-24";13527;12573;26100
"734";"Concepción";"25-29";10541;9734;20275
"735";"Concepción";"30-34";7548;7495;15043
"736";"Concepción";"35-39";6622;7138;13760
"737";"Concepción";"40-44";7271;8189;15460
"738";"Concepción";"45-49";8024;8687;16711
"739";"Concepción";"50-54";7403;8379;15782
"740";"Concepción";"55-59";6143;7122;13265
"741";"Concepción";"60-64";4549;5422;9971
"742";"Concepción";"65-69";3465;4422;7887
"743";"Concepción";"70-74";2557;3729;6286
"744";"Concepción";"75-80";3353;6522;9875
"745";"Conchalí";"20-24";5582;5203;10785
"746";"Conchalí";"25-29";5825;5701;11526
"747";"Conchalí";"30-34";5605;5136;10741
"748";"Conchalí";"35-39";5018;4963;9981
"749";"Conchalí";"40-44";4759;4525;9284
"750";"Conchalí";"45-49";4525;4588;9113
"751";"Conchalí";"50-54";4305;4872;9177
"752";"Conchalí";"55-59";3951;4386;8337
"753";"Conchalí";"60-64";3604;4220;7824
"754";"Conchalí";"65-69";3119;3727;6846
"755";"Conchalí";"70-74";2160;2857;5017
"756";"Conchalí";"75-80";2414;3915;6329
"757";"Concón";"20-24";2040;1937;3977
"758";"Concón";"25-29";2035;2022;4057
"759";"Concón";"30-34";1846;1725;3571
"760";"Concón";"35-39";1651;1706;3357
"761";"Concón";"40-44";1592;1652;3244
"762";"Concón";"45-49";1578;1715;3293
"763";"Concón";"50-54";1411;1476;2887
"764";"Concón";"55-59";1205;1144;2349
"765";"Concón";"60-64";812;925;1737
"766";"Concón";"65-69";581;751;1332
"767";"Concón";"70-74";448;518;966
"768";"Concón";"75-80";525;914;1439
"769";"Constitución";"20-24";2289;2315;4604
"770";"Constitución";"25-29";2145;2116;4261
"771";"Constitución";"30-34";1708;1770;3478
"772";"Constitución";"35-39";1811;1731;3542
"773";"Constitución";"40-44";1773;1819;3592
"774";"Constitución";"45-49";1825;1812;3637
"775";"Constitución";"50-54";1621;1439;3060
"776";"Constitución";"55-59";1296;1149;2445
"777";"Constitución";"60-64";870;934;1804
"778";"Constitución";"65-69";699;748;1447
"779";"Constitución";"70-74";487;589;1076
"780";"Constitución";"75-80";648;831;1479
"781";"Contulmo";"20-24";226;216;442
"782";"Contulmo";"25-29";212;209;421
"783";"Contulmo";"30-34";163;182;345
"784";"Contulmo";"35-39";171;161;332
"785";"Contulmo";"40-44";219;185;404
"786";"Contulmo";"45-49";205;212;417
"787";"Contulmo";"50-54";214;161;375
"788";"Contulmo";"55-59";183;143;326
"789";"Contulmo";"60-64";157;138;295
"790";"Contulmo";"65-69";135;115;250
"791";"Contulmo";"70-74";92;70;162
"792";"Contulmo";"75-80";133;174;307
"793";"Copiapó";"20-24";7914;7334;15248
"794";"Copiapó";"25-29";6955;6404;13359
"795";"Copiapó";"30-34";6182;5604;11786
"796";"Copiapó";"35-39";6083;5548;11631
"797";"Copiapó";"40-44";6224;5691;11915
"798";"Copiapó";"45-49";6130;5678;11808
"799";"Copiapó";"50-54";5356;5120;10476
"800";"Copiapó";"55-59";4367;4001;8368
"801";"Copiapó";"60-64";3130;3049;6179
"802";"Copiapó";"65-69";2282;2292;4574
"803";"Copiapó";"70-74";1715;1798;3513
"804";"Copiapó";"75-80";2106;2950;5056
"805";"Coquimbo";"20-24";9891;10068;19959
"806";"Coquimbo";"25-29";8904;8806;17710
"807";"Coquimbo";"30-34";7625;7912;15537
"808";"Coquimbo";"35-39";7328;7785;15113
"809";"Coquimbo";"40-44";7612;8258;15870
"810";"Coquimbo";"45-49";7583;8202;15785
"811";"Coquimbo";"50-54";6886;7375;14261
"812";"Coquimbo";"55-59";5694;5883;11577
"813";"Coquimbo";"60-64";4086;4497;8583
"814";"Coquimbo";"65-69";3018;3561;6579
"815";"Coquimbo";"70-74";2410;2983;5393
"816";"Coquimbo";"75-80";3090;4812;7902
"817";"Coronel";"20-24";4765;4768;9533
"818";"Coronel";"25-29";4436;4585;9021
"819";"Coronel";"30-34";3841;4208;8049
"820";"Coronel";"35-39";3985;4111;8096
"821";"Coronel";"40-44";4213;4289;8502
"822";"Coronel";"45-49";4263;4238;8501
"823";"Coronel";"50-54";3528;3719;7247
"824";"Coronel";"55-59";2635;3025;5660
"825";"Coronel";"60-64";2112;2314;4426
"826";"Coronel";"65-69";1707;1918;3625
"827";"Coronel";"70-74";1313;1597;2910
"828";"Coronel";"75-80";1429;2101;3530
"829";"Corral";"20-24";193;185;378
"830";"Corral";"25-29";216;242;458
"831";"Corral";"30-34";213;213;426
"832";"Corral";"35-39";220;164;384
"833";"Corral";"40-44";191;192;383
"834";"Corral";"45-49";223;183;406
"835";"Corral";"50-54";230;158;388
"836";"Corral";"55-59";185;146;331
"837";"Corral";"60-64";149;155;304
"838";"Corral";"65-69";132;128;260
"839";"Corral";"70-74";100;90;190
"840";"Corral";"75-80";118;148;266
"841";"Coyhaique";"20-24";2498;2317;4815
"842";"Coyhaique";"25-29";2220;2029;4249
"843";"Coyhaique";"30-34";1907;1990;3897
"844";"Coyhaique";"35-39";2126;2283;4409
"845";"Coyhaique";"40-44";2218;2328;4546
"846";"Coyhaique";"45-49";2296;2226;4522
"847";"Coyhaique";"50-54";2104;1820;3924
"848";"Coyhaique";"55-59";1701;1427;3128
"849";"Coyhaique";"60-64";1099;974;2073
"850";"Coyhaique";"65-69";779;758;1537
"851";"Coyhaique";"70-74";584;594;1178
"852";"Coyhaique";"75-80";736;924;1660
"853";"Cunco";"20-24";645;606;1251
"854";"Cunco";"25-29";642;674;1316
"855";"Cunco";"30-34";510;613;1123
"856";"Cunco";"35-39";568;532;1100
"857";"Cunco";"40-44";664;620;1284
"858";"Cunco";"45-49";671;670;1341
"859";"Cunco";"50-54";634;632;1266
"860";"Cunco";"55-59";572;537;1109
"861";"Cunco";"60-64";500;471;971
"862";"Cunco";"65-69";397;410;807
"863";"Cunco";"70-74";333;340;673
"864";"Cunco";"75-80";503;568;1071
"865";"Curacautín";"20-24";671;633;1304
"866";"Curacautín";"25-29";549;590;1139
"867";"Curacautín";"30-34";482;531;1013
"868";"Curacautín";"35-39";545;564;1109
"869";"Curacautín";"40-44";578;632;1210
"870";"Curacautín";"45-49";621;663;1284
"871";"Curacautín";"50-54";630;697;1327
"872";"Curacautín";"55-59";526;485;1011
"873";"Curacautín";"60-64";439;408;847
"874";"Curacautín";"65-69";347;367;714
"875";"Curacautín";"70-74";293;294;587
"876";"Curacautín";"75-80";372;558;930
"877";"Curacaví";"20-24";1146;1083;2229
"878";"Curacaví";"25-29";1111;1017;2128
"879";"Curacaví";"30-34";1077;1146;2223
"880";"Curacaví";"35-39";1118;1067;2185
"881";"Curacaví";"40-44";1120;1017;2137
"882";"Curacaví";"45-49";1016;940;1956
"883";"Curacaví";"50-54";997;930;1927
"884";"Curacaví";"55-59";746;728;1474
"885";"Curacaví";"60-64";702;676;1378
"886";"Curacaví";"65-69";593;491;1084
"887";"Curacaví";"70-74";378;318;696
"888";"Curacaví";"75-80";459;519;978
"889";"Curaco de Vélez";"20-24";146;129;275
"890";"Curaco de Vélez";"25-29";132;106;238
"891";"Curaco de Vélez";"30-34";127;116;243
"892";"Curaco de Vélez";"35-39";126;121;247
"893";"Curaco de Vélez";"40-44";121;127;248
"894";"Curaco de Vélez";"45-49";141;138;279
"895";"Curaco de Vélez";"50-54";127;141;268
"896";"Curaco de Vélez";"55-59";123;114;237
"897";"Curaco de Vélez";"60-64";104;119;223
"898";"Curaco de Vélez";"65-69";84;99;183
"899";"Curaco de Vélez";"70-74";63;96;159
"900";"Curaco de Vélez";"75-80";99;192;291
"901";"Curanilahue";"20-24";1568;1496;3064
"902";"Curanilahue";"25-29";1489;1426;2915
"903";"Curanilahue";"30-34";1108;1146;2254
"904";"Curanilahue";"35-39";1111;1114;2225
"905";"Curanilahue";"40-44";1245;1207;2452
"906";"Curanilahue";"45-49";1317;1265;2582
"907";"Curanilahue";"50-54";1209;1113;2322
"908";"Curanilahue";"55-59";894;854;1748
"909";"Curanilahue";"60-64";613;673;1286
"910";"Curanilahue";"65-69";552;557;1109
"911";"Curanilahue";"70-74";416;455;871
"912";"Curanilahue";"75-80";611;712;1323
"913";"Curarrehue";"20-24";326;280;606
"914";"Curarrehue";"25-29";301;243;544
"915";"Curarrehue";"30-34";242;251;493
"916";"Curarrehue";"35-39";236;213;449
"917";"Curarrehue";"40-44";207;214;421
"918";"Curarrehue";"45-49";242;208;450
"919";"Curarrehue";"50-54";232;201;433
"920";"Curarrehue";"55-59";191;172;363
"921";"Curarrehue";"60-64";194;130;324
"922";"Curarrehue";"65-69";158;136;294
"923";"Curarrehue";"70-74";105;87;192
"924";"Curarrehue";"75-80";166;173;339
"925";"Curepto";"20-24";396;343;739
"926";"Curepto";"25-29";360;334;694
"927";"Curepto";"30-34";349;254;603
"928";"Curepto";"35-39";352;301;653
"929";"Curepto";"40-44";444;343;787
"930";"Curepto";"45-49";496;352;848
"931";"Curepto";"50-54";439;387;826
"932";"Curepto";"55-59";374;308;682
"933";"Curepto";"60-64";369;352;721
"934";"Curepto";"65-69";304;300;604
"935";"Curepto";"70-74";245;204;449
"936";"Curepto";"75-80";296;382;678
"937";"Curicó";"20-24";6221;6200;12421
"938";"Curicó";"25-29";5544;5937;11481
"939";"Curicó";"30-34";4626;4788;9414
"940";"Curicó";"35-39";4900;5219;10119
"941";"Curicó";"40-44";5177;5551;10728
"942";"Curicó";"45-49";5261;5620;10881
"943";"Curicó";"50-54";4627;4885;9512
"944";"Curicó";"55-59";3648;3906;7554
"945";"Curicó";"60-64";2810;3045;5855
"946";"Curicó";"65-69";2058;2559;4617
"947";"Curicó";"70-74";1606;1924;3530
"948";"Curicó";"75-80";1840;2906;4746
"949";"Dalcahue";"20-24";623;622;1245
"950";"Dalcahue";"25-29";587;560;1147
"951";"Dalcahue";"30-34";551;462;1013
"952";"Dalcahue";"35-39";549;499;1048
"953";"Dalcahue";"40-44";530;443;973
"954";"Dalcahue";"45-49";521;469;990
"955";"Dalcahue";"50-54";441;386;827
"956";"Dalcahue";"55-59";372;390;762
"957";"Dalcahue";"60-64";293;280;573
"958";"Dalcahue";"65-69";254;266;520
"959";"Dalcahue";"70-74";197;258;455
"960";"Dalcahue";"75-80";271;413;684
"961";"Diego de Almagro";"20-24";591;563;1154
"962";"Diego de Almagro";"25-29";754;640;1394
"963";"Diego de Almagro";"30-34";633;530;1163
"964";"Diego de Almagro";"35-39";637;555;1192
"965";"Diego de Almagro";"40-44";750;654;1404
"966";"Diego de Almagro";"45-49";796;573;1369
"967";"Diego de Almagro";"50-54";789;499;1288
"968";"Diego de Almagro";"55-59";508;336;844
"969";"Diego de Almagro";"60-64";247;201;448
"970";"Diego de Almagro";"65-69";167;110;277
"971";"Diego de Almagro";"70-74";114;79;193
"972";"Diego de Almagro";"75-80";120;169;289
"973";"Doñihue";"20-24";939;898;1837
"974";"Doñihue";"25-29";719;666;1385
"975";"Doñihue";"30-34";669;622;1291
"976";"Doñihue";"35-39";647;666;1313
"977";"Doñihue";"40-44";673;704;1377
"978";"Doñihue";"45-49";845;727;1572
"979";"Doñihue";"50-54";667;652;1319
"980";"Doñihue";"55-59";523;546;1069
"981";"Doñihue";"60-64";452;426;878
"982";"Doñihue";"65-69";327;371;698
"983";"Doñihue";"70-74";248;283;531
"984";"Doñihue";"75-80";281;477;758
"985";"El Bosque";"20-24";8801;8090;16891
"986";"El Bosque";"25-29";7931;7384;15315
"987";"El Bosque";"30-34";7111;6897;14008
"988";"El Bosque";"35-39";6517;6503;13020
"989";"El Bosque";"40-44";6596;6587;13183
"990";"El Bosque";"45-49";6682;7046;13728
"991";"El Bosque";"50-54";6183;6704;12887
"992";"El Bosque";"55-59";5305;5679;10984
"993";"El Bosque";"60-64";4050;4612;8662
"994";"El Bosque";"65-69";3236;3779;7015
"995";"El Bosque";"70-74";2012;2543;4555
"996";"El Bosque";"75-80";2053;3672;5725
"997";"El Carmen";"20-24";541;505;1046
"998";"El Carmen";"25-29";518;466;984
"999";"El Carmen";"30-34";417;379;796
"1000";"El Carmen";"35-39";391;396;787
"1001";"El Carmen";"40-44";407;358;765
"1002";"El Carmen";"45-49";483;364;847
"1003";"El Carmen";"50-54";437;407;844
"1004";"El Carmen";"55-59";364;394;758
"1005";"El Carmen";"60-64";366;365;731
"1006";"El Carmen";"65-69";355;290;645
"1007";"El Carmen";"70-74";222;208;430
"1008";"El Carmen";"75-80";281;332;613
"1009";"El Monte";"20-24";1376;1331;2707
"1010";"El Monte";"25-29";1359;1401;2760
"1011";"El Monte";"30-34";1401;1301;2702
"1012";"El Monte";"35-39";1298;1209;2507
"1013";"El Monte";"40-44";1139;1116;2255
"1014";"El Monte";"45-49";1159;1039;2198
"1015";"El Monte";"50-54";1078;1094;2172
"1016";"El Monte";"55-59";880;846;1726
"1017";"El Monte";"60-64";709;704;1413
"1018";"El Monte";"65-69";564;579;1143
"1019";"El Monte";"70-74";375;372;747
"1020";"El Monte";"75-80";547;712;1259
"1021";"El Quisco";"20-24";408;398;806
"1022";"El Quisco";"25-29";520;468;988
"1023";"El Quisco";"30-34";433;407;840
"1024";"El Quisco";"35-39";370;345;715
"1025";"El Quisco";"40-44";410;379;789
"1026";"El Quisco";"45-49";400;362;762
"1027";"El Quisco";"50-54";482;421;903
"1028";"El Quisco";"55-59";348;434;782
"1029";"El Quisco";"60-64";388;423;811
"1030";"El Quisco";"65-69";373;361;734
"1031";"El Quisco";"70-74";298;284;582
"1032";"El Quisco";"75-80";307;358;665
"1033";"El Tabo";"20-24";282;242;524
"1034";"El Tabo";"25-29";363;346;709
"1035";"El Tabo";"30-34";349;267;616
"1036";"El Tabo";"35-39";306;255;561
"1037";"El Tabo";"40-44";298;309;607
"1038";"El Tabo";"45-49";341;308;649
"1039";"El Tabo";"50-54";349;332;681
"1040";"El Tabo";"55-59";366;356;722
"1041";"El Tabo";"60-64";293;279;572
"1042";"El Tabo";"65-69";324;295;619
"1043";"El Tabo";"70-74";216;247;463
"1044";"El Tabo";"75-80";274;306;580
"1045";"Empedrado";"20-24";201;193;394
"1046";"Empedrado";"25-29";188;171;359
"1047";"Empedrado";"30-34";151;164;315
"1048";"Empedrado";"35-39";123;119;242
"1049";"Empedrado";"40-44";161;124;285
"1050";"Empedrado";"45-49";161;126;287
"1051";"Empedrado";"50-54";165;122;287
"1052";"Empedrado";"55-59";142;129;271
"1053";"Empedrado";"60-64";129;101;230
"1054";"Empedrado";"65-69";84;63;147
"1055";"Empedrado";"70-74";67;61;128
"1056";"Empedrado";"75-80";90;100;190
"1057";"Ercilla";"20-24";424;329;753
"1058";"Ercilla";"25-29";321;333;654
"1059";"Ercilla";"30-34";285;281;566
"1060";"Ercilla";"35-39";273;259;532
"1061";"Ercilla";"40-44";292;252;544
"1062";"Ercilla";"45-49";324;298;622
"1063";"Ercilla";"50-54";314;276;590
"1064";"Ercilla";"55-59";290;249;539
"1065";"Ercilla";"60-64";223;176;399
"1066";"Ercilla";"65-69";172;170;342
"1067";"Ercilla";"70-74";140;119;259
"1068";"Ercilla";"75-80";192;223;415
"1069";"Estación Central";"20-24";6577;5714;12291
"1070";"Estación Central";"25-29";6736;5826;12562
"1071";"Estación Central";"30-34";5498;5032;10530
"1072";"Estación Central";"35-39";5228;4908;10136
"1073";"Estación Central";"40-44";4833;4750;9583
"1074";"Estación Central";"45-49";4768;4821;9589
"1075";"Estación Central";"50-54";4593;5058;9651
"1076";"Estación Central";"55-59";4014;4895;8909
"1077";"Estación Central";"60-64";3605;4171;7776
"1078";"Estación Central";"65-69";2768;3418;6186
"1079";"Estación Central";"70-74";2060;2685;4745
"1080";"Estación Central";"75-80";2518;4499;7017
"1081";"Florida";"20-24";318;290;608
"1082";"Florida";"25-29";303;296;599
"1083";"Florida";"30-34";336;286;622
"1084";"Florida";"35-39";266;311;577
"1085";"Florida";"40-44";310;335;645
"1086";"Florida";"45-49";355;311;666
"1087";"Florida";"50-54";341;307;648
"1088";"Florida";"55-59";323;255;578
"1089";"Florida";"60-64";252;246;498
"1090";"Florida";"65-69";204;194;398
"1091";"Florida";"70-74";177;178;355
"1092";"Florida";"75-80";212;280;492
"1093";"Freire";"20-24";1033;872;1905
"1094";"Freire";"25-29";990;966;1956
"1095";"Freire";"30-34";821;814;1635
"1096";"Freire";"35-39";833;762;1595
"1097";"Freire";"40-44";916;804;1720
"1098";"Freire";"45-49";962;831;1793
"1099";"Freire";"50-54";828;710;1538
"1100";"Freire";"55-59";783;669;1452
"1101";"Freire";"60-64";586;559;1145
"1102";"Freire";"65-69";470;527;997
"1103";"Freire";"70-74";345;358;703
"1104";"Freire";"75-80";550;697;1247
"1105";"Freirina";"20-24";253;231;484
"1106";"Freirina";"25-29";225;238;463
"1107";"Freirina";"30-34";203;214;417
"1108";"Freirina";"35-39";240;214;454
"1109";"Freirina";"40-44";215;200;415
"1110";"Freirina";"45-49";219;236;455
"1111";"Freirina";"50-54";191;233;424
"1112";"Freirina";"55-59";209;167;376
"1113";"Freirina";"60-64";185;149;334
"1114";"Freirina";"65-69";120;117;237
"1115";"Freirina";"70-74";92;99;191
"1116";"Freirina";"75-80";107;180;287
"1117";"Fresia";"20-24";405;367;772
"1118";"Fresia";"25-29";458;376;834
"1119";"Fresia";"30-34";409;370;779
"1120";"Fresia";"35-39";489;413;902
"1121";"Fresia";"40-44";513;441;954
"1122";"Fresia";"45-49";592;469;1061
"1123";"Fresia";"50-54";512;400;912
"1124";"Fresia";"55-59";393;319;712
"1125";"Fresia";"60-64";324;284;608
"1126";"Fresia";"65-69";260;245;505
"1127";"Fresia";"70-74";195;214;409
"1128";"Fresia";"75-80";263;337;600
"1129";"Frutillar";"20-24";619;631;1250
"1130";"Frutillar";"25-29";606;572;1178
"1131";"Frutillar";"30-34";503;496;999
"1132";"Frutillar";"35-39";616;633;1249
"1133";"Frutillar";"40-44";705;643;1348
"1134";"Frutillar";"45-49";730;620;1350
"1135";"Frutillar";"50-54";580;512;1092
"1136";"Frutillar";"55-59";507;428;935
"1137";"Frutillar";"60-64";377;403;780
"1138";"Frutillar";"65-69";284;296;580
"1139";"Frutillar";"70-74";251;240;491
"1140";"Frutillar";"75-80";233;352;585
"1141";"Futaleufú";"20-24";96;102;198
"1142";"Futaleufú";"25-29";107;93;200
"1143";"Futaleufú";"30-34";120;117;237
"1144";"Futaleufú";"35-39";141;127;268
"1145";"Futaleufú";"40-44";154;123;277
"1146";"Futaleufú";"45-49";145;105;250
"1147";"Futaleufú";"50-54";101;125;226
"1148";"Futaleufú";"55-59";106;119;225
"1149";"Futaleufú";"60-64";136;71;207
"1150";"Futaleufú";"65-69";64;61;125
"1151";"Futaleufú";"70-74";46;53;99
"1152";"Futaleufú";"75-80";58;63;121
"1153";"Futrono";"20-24";684;672;1356
"1154";"Futrono";"25-29";707;705;1412
"1155";"Futrono";"30-34";555;594;1149
"1156";"Futrono";"35-39";534;466;1000
"1157";"Futrono";"40-44";582;500;1082
"1158";"Futrono";"45-49";561;557;1118
"1159";"Futrono";"50-54";500;464;964
"1160";"Futrono";"55-59";459;367;826
"1161";"Futrono";"60-64";358;316;674
"1162";"Futrono";"65-69";261;254;515
"1163";"Futrono";"70-74";217;157;374
"1164";"Futrono";"75-80";262;271;533
"1165";"Galvarino";"20-24";515;467;982
"1166";"Galvarino";"25-29";446;443;889
"1167";"Galvarino";"30-34";361;347;708
"1168";"Galvarino";"35-39";415;363;778
"1169";"Galvarino";"40-44";466;409;875
"1170";"Galvarino";"45-49";475;379;854
"1171";"Galvarino";"50-54";422;365;787
"1172";"Galvarino";"55-59";374;364;738
"1173";"Galvarino";"60-64";305;297;602
"1174";"Galvarino";"65-69";250;239;489
"1175";"Galvarino";"70-74";226;203;429
"1176";"Galvarino";"75-80";265;333;598
"1177";"General Lagos";"20-24";35;20;55
"1178";"General Lagos";"25-29";23;20;43
"1179";"General Lagos";"30-34";21;20;41
"1180";"General Lagos";"35-39";15;14;29
"1181";"General Lagos";"40-44";22;17;39
"1182";"General Lagos";"45-49";9;15;24
"1183";"General Lagos";"50-54";18;22;40
"1184";"General Lagos";"55-59";20;22;42
"1185";"General Lagos";"60-64";13;14;27
"1186";"General Lagos";"65-69";17;14;31
"1187";"General Lagos";"70-74";8;9;17
"1188";"General Lagos";"75-80";17;24;41
"1189";"Gorbea";"20-24";644;601;1245
"1190";"Gorbea";"25-29";566;550;1116
"1191";"Gorbea";"30-34";511;500;1011
"1192";"Gorbea";"35-39";503;487;990
"1193";"Gorbea";"40-44";541;524;1065
"1194";"Gorbea";"45-49";583;521;1104
"1195";"Gorbea";"50-54";551;481;1032
"1196";"Gorbea";"55-59";490;468;958
"1197";"Gorbea";"60-64";388;407;795
"1198";"Gorbea";"65-69";340;305;645
"1199";"Gorbea";"70-74";260;297;557
"1200";"Gorbea";"75-80";358;595;953
"1201";"Graneros";"20-24";1567;1465;3032
"1202";"Graneros";"25-29";1285;1174;2459
"1203";"Graneros";"30-34";1076;1030;2106
"1204";"Graneros";"35-39";1225;1186;2411
"1205";"Graneros";"40-44";1209;1231;2440
"1206";"Graneros";"45-49";1166;1176;2342
"1207";"Graneros";"50-54";1057;1050;2107
"1208";"Graneros";"55-59";866;975;1841
"1209";"Graneros";"60-64";699;638;1337
"1210";"Graneros";"65-69";539;591;1130
"1211";"Graneros";"70-74";376;351;727
"1212";"Graneros";"75-80";392;598;990
"1213";"Guaitecas";"20-24";106;87;193
"1214";"Guaitecas";"25-29";97;54;151
"1215";"Guaitecas";"30-34";96;62;158
"1216";"Guaitecas";"35-39";87;67;154
"1217";"Guaitecas";"40-44";55;46;101
"1218";"Guaitecas";"45-49";63;32;95
"1219";"Guaitecas";"50-54";67;41;108
"1220";"Guaitecas";"55-59";51;25;76
"1221";"Guaitecas";"60-64";32;29;61
"1222";"Guaitecas";"65-69";36;21;57
"1223";"Guaitecas";"70-74";19;6;25
"1224";"Guaitecas";"75-80";22;22;44
"1225";"Hijuela";"20-24";728;723;1451
"1226";"Hijuela";"25-29";769;806;1575
"1227";"Hijuela";"30-34";698;627;1325
"1228";"Hijuela";"35-39";615;641;1256
"1229";"Hijuela";"40-44";600;575;1175
"1230";"Hijuela";"45-49";631;569;1200
"1231";"Hijuela";"50-54";559;538;1097
"1232";"Hijuela";"55-59";475;428;903
"1233";"Hijuela";"60-64";357;338;695
"1234";"Hijuela";"65-69";291;279;570
"1235";"Hijuela";"70-74";227;249;476
"1236";"Hijuela";"75-80";319;356;675
"1237";"Hualaihué";"20-24";534;402;936
"1238";"Hualaihué";"25-29";434;371;805
"1239";"Hualaihué";"30-34";426;330;756
"1240";"Hualaihué";"35-39";445;362;807
"1241";"Hualaihué";"40-44";456;320;776
"1242";"Hualaihué";"45-49";439;277;716
"1243";"Hualaihué";"50-54";353;287;640
"1244";"Hualaihué";"55-59";270;238;508
"1245";"Hualaihué";"60-64";241;208;449
"1246";"Hualaihué";"65-69";207;152;359
"1247";"Hualaihué";"70-74";126;135;261
"1248";"Hualaihué";"75-80";175;188;363
"1249";"Hualañé";"20-24";394;362;756
"1250";"Hualañé";"25-29";339;339;678
"1251";"Hualañé";"30-34";322;307;629
"1252";"Hualañé";"35-39";348;322;670
"1253";"Hualañé";"40-44";406;332;738
"1254";"Hualañé";"45-49";418;401;819
"1255";"Hualañé";"50-54";442;356;798
"1256";"Hualañé";"55-59";343;306;649
"1257";"Hualañé";"60-64";268;248;516
"1258";"Hualañé";"65-69";220;212;432
"1259";"Hualañé";"70-74";174;147;321
"1260";"Hualañé";"75-80";251;313;564
"1261";"Hualpén";"20-24";5102;4820;9922
"1262";"Hualpén";"25-29";4552;4471;9023
"1263";"Hualpén";"30-34";3524;3676;7200
"1264";"Hualpén";"35-39";3291;3542;6833
"1265";"Hualpén";"40-44";3539;3908;7447
"1266";"Hualpén";"45-49";3621;4121;7742
"1267";"Hualpén";"50-54";3492;3744;7236
"1268";"Hualpén";"55-59";2953;3560;6513
"1269";"Hualpén";"60-64";2348;2779;5127
"1270";"Hualpén";"65-69";1852;2328;4180
"1271";"Hualpén";"70-74";1268;1698;2966
"1272";"Hualpén";"75-80";1148;2228;3376
"1273";"Hualqui";"20-24";1132;1089;2221
"1274";"Hualqui";"25-29";956;926;1882
"1275";"Hualqui";"30-34";752;896;1648
"1276";"Hualqui";"35-39";800;784;1584
"1277";"Hualqui";"40-44";806;859;1665
"1278";"Hualqui";"45-49";785;817;1602
"1279";"Hualqui";"50-54";767;762;1529
"1280";"Hualqui";"55-59";653;646;1299
"1281";"Hualqui";"60-64";535;556;1091
"1282";"Hualqui";"65-69";475;460;935
"1283";"Hualqui";"70-74";352;364;716
"1284";"Hualqui";"75-80";415;631;1046
"1285";"Huara";"20-24";98;77;175
"1286";"Huara";"25-29";112;88;200
"1287";"Huara";"30-34";102;93;195
"1288";"Huara";"35-39";96;63;159
"1289";"Huara";"40-44";95;42;137
"1290";"Huara";"45-49";95;64;159
"1291";"Huara";"50-54";144;95;239
"1292";"Huara";"55-59";92;64;156
"1293";"Huara";"60-64";98;50;148
"1294";"Huara";"65-69";88;43;131
"1295";"Huara";"70-74";60;50;110
"1296";"Huara";"75-80";89;83;172
"1297";"Huasco";"20-24";363;327;690
"1298";"Huasco";"25-29";345;270;615
"1299";"Huasco";"30-34";304;311;615
"1300";"Huasco";"35-39";353;340;693
"1301";"Huasco";"40-44";374;361;735
"1302";"Huasco";"45-49";378;402;780
"1303";"Huasco";"50-54";384;359;743
"1304";"Huasco";"55-59";302;268;570
"1305";"Huasco";"60-64";248;227;475
"1306";"Huasco";"65-69";182;181;363
"1307";"Huasco";"70-74";145;132;277
"1308";"Huasco";"75-80";176;207;383
"1309";"Huechuraba";"20-24";3457;3464;6921
"1310";"Huechuraba";"25-29";3820;4084;7904
"1311";"Huechuraba";"30-34";4434;4662;9096
"1312";"Huechuraba";"35-39";3862;3604;7466
"1313";"Huechuraba";"40-44";3038;2698;5736
"1314";"Huechuraba";"45-49";2579;2678;5257
"1315";"Huechuraba";"50-54";2946;3124;6070
"1316";"Huechuraba";"55-59";2743;2875;5618
"1317";"Huechuraba";"60-64";1985;2072;4057
"1318";"Huechuraba";"65-69";1360;1473;2833
"1319";"Huechuraba";"70-74";739;907;1646
"1320";"Huechuraba";"75-80";684;1218;1902
"1321";"Illapel";"20-24";1162;1194;2356
"1322";"Illapel";"25-29";1010;1087;2097
"1323";"Illapel";"30-34";1030;1072;2102
"1324";"Illapel";"35-39";1019;1108;2127
"1325";"Illapel";"40-44";1161;1201;2362
"1326";"Illapel";"45-49";1084;1203;2287
"1327";"Illapel";"50-54";1163;1141;2304
"1328";"Illapel";"55-59";945;931;1876
"1329";"Illapel";"60-64";726;755;1481
"1330";"Illapel";"65-69";601;641;1242
"1331";"Illapel";"70-74";437;523;960
"1332";"Illapel";"75-80";677;975;1652
"1333";"Inpendencia";"20-24";3192;2971;6163
"1334";"Inpendencia";"25-29";3355;3221;6576
"1335";"Inpendencia";"30-34";2764;2607;5371
"1336";"Inpendencia";"35-39";2551;2421;4972
"1337";"Inpendencia";"40-44";2473;2624;5097
"1338";"Inpendencia";"45-49";2739;2982;5721
"1339";"Inpendencia";"50-54";2752;3115;5867
"1340";"Inpendencia";"55-59";2541;2973;5514
"1341";"Inpendencia";"60-64";2057;2493;4550
"1342";"Inpendencia";"65-69";1661;2165;3826
"1343";"Inpendencia";"70-74";1360;1891;3251
"1344";"Inpendencia";"75-80";1918;4670;6588
"1345";"Iquique";"20-24";8879;7895;16774
"1346";"Iquique";"25-29";8838;7653;16491
"1347";"Iquique";"30-34";7490;6881;14371
"1348";"Iquique";"35-39";6979;6764;13743
"1349";"Iquique";"40-44";6914;7010;13924
"1350";"Iquique";"45-49";7353;6916;14269
"1351";"Iquique";"50-54";6669;6593;13262
"1352";"Iquique";"55-59";6045;5439;11484
"1353";"Iquique";"60-64";4156;4083;8239
"1354";"Iquique";"65-69";2981;3019;6000
"1355";"Iquique";"70-74";1870;2258;4128
"1356";"Iquique";"75-80";2274;3723;5997
"1357";"Isla de  Pascua";"20-24";167;185;352
"1358";"Isla de  Pascua";"25-29";311;303;614
"1359";"Isla de  Pascua";"30-34";299;257;556
"1360";"Isla de  Pascua";"35-39";246;214;460
"1361";"Isla de  Pascua";"40-44";239;220;459
"1362";"Isla de  Pascua";"45-49";270;214;484
"1363";"Isla de  Pascua";"50-54";223;184;407
"1364";"Isla de  Pascua";"55-59";174;132;306
"1365";"Isla de  Pascua";"60-64";108;109;217
"1366";"Isla de  Pascua";"65-69";48;71;119
"1367";"Isla de  Pascua";"70-74";23;36;59
"1368";"Isla de  Pascua";"75-80";51;55;106
"1369";"Isla de Maipo";"20-24";1356;1317;2673
"1370";"Isla de Maipo";"25-29";1365;1335;2700
"1371";"Isla de Maipo";"30-34";1309;1362;2671
"1372";"Isla de Maipo";"35-39";1327;1269;2596
"1373";"Isla de Maipo";"40-44";1241;1251;2492
"1374";"Isla de Maipo";"45-49";1214;1082;2296
"1375";"Isla de Maipo";"50-54";1004;968;1972
"1376";"Isla de Maipo";"55-59";874;855;1729
"1377";"Isla de Maipo";"60-64";735;633;1368
"1378";"Isla de Maipo";"65-69";590;540;1130
"1379";"Isla de Maipo";"70-74";373;379;752
"1380";"Isla de Maipo";"75-80";603;677;1280
"1381";"Juan Fernández";"20-24";33;25;58
"1382";"Juan Fernández";"25-29";49;39;88
"1383";"Juan Fernández";"30-34";54;33;87
"1384";"Juan Fernández";"35-39";28;33;61
"1385";"Juan Fernández";"40-44";35;35;70
"1386";"Juan Fernández";"45-49";41;38;79
"1387";"Juan Fernández";"50-54";35;24;59
"1388";"Juan Fernández";"55-59";21;27;48
"1389";"Juan Fernández";"60-64";19;25;44
"1390";"Juan Fernández";"65-69";13;6;19
"1391";"Juan Fernández";"70-74";7;10;17
"1392";"Juan Fernández";"75-80";9;12;21
"1393";"La Calera";"20-24";2166;2229;4395
"1394";"La Calera";"25-29";2372;2417;4789
"1395";"La Calera";"30-34";2028;1896;3924
"1396";"La Calera";"35-39";1714;1739;3453
"1397";"La Calera";"40-44";1673;1783;3456
"1398";"La Calera";"45-49";1923;1893;3816
"1399";"La Calera";"50-54";1729;1897;3626
"1400";"La Calera";"55-59";1431;1604;3035
"1401";"La Calera";"60-64";1194;1316;2510
"1402";"La Calera";"65-69";919;1025;1944
"1403";"La Calera";"70-74";656;828;1484
"1404";"La Calera";"75-80";966;1453;2419
"1405";"La Cisterna";"20-24";3628;3576;7204
"1406";"La Cisterna";"25-29";3684;3528;7212
"1407";"La Cisterna";"30-34";3172;3219;6391
"1408";"La Cisterna";"35-39";2931;2836;5767
"1409";"La Cisterna";"40-44";2903;3111;6014
"1410";"La Cisterna";"45-49";3099;3405;6504
"1411";"La Cisterna";"50-54";3248;3769;7017
"1412";"La Cisterna";"55-59";2747;3182;5929
"1413";"La Cisterna";"60-64";2308;2755;5063
"1414";"La Cisterna";"65-69";1994;2379;4373
"1415";"La Cisterna";"70-74";1347;1877;3224
"1416";"La Cisterna";"75-80";1787;3333;5120
"1417";"La Cruz";"20-24";658;668;1326
"1418";"La Cruz";"25-29";743;686;1429
"1419";"La Cruz";"30-34";662;701;1363
"1420";"La Cruz";"35-39";643;635;1278
"1421";"La Cruz";"40-44";593;560;1153
"1422";"La Cruz";"45-49";635;643;1278
"1423";"La Cruz";"50-54";605;631;1236
"1424";"La Cruz";"55-59";529;534;1063
"1425";"La Cruz";"60-64";424;451;875
"1426";"La Cruz";"65-69";369;331;700
"1427";"La Cruz";"70-74";236;280;516
"1428";"La Cruz";"75-80";371;523;894
"1429";"La Estrella";"20-24";104;105;209
"1430";"La Estrella";"25-29";76;109;185
"1431";"La Estrella";"30-34";54;94;148
"1432";"La Estrella";"35-39";72;115;187
"1433";"La Estrella";"40-44";83;112;195
"1434";"La Estrella";"45-49";66;124;190
"1435";"La Estrella";"50-54";77;109;186
"1436";"La Estrella";"55-59";68;110;178
"1437";"La Estrella";"60-64";50;88;138
"1438";"La Estrella";"65-69";38;75;113
"1439";"La Estrella";"70-74";23;56;79
"1440";"La Estrella";"75-80";66;152;218
"1441";"La Florida";"20-24";17322;17168;34490
"1442";"La Florida";"25-29";16506;16391;32897
"1443";"La Florida";"30-34";14163;13997;28160
"1444";"La Florida";"35-39";12464;13100;25564
"1445";"La Florida";"40-44";13197;14680;27877
"1446";"La Florida";"45-49";14878;16756;31634
"1447";"La Florida";"50-54";14584;16001;30585
"1448";"La Florida";"55-59";11475;12335;23810
"1449";"La Florida";"60-64";7925;8903;16828
"1450";"La Florida";"65-69";5239;6421;11660
"1451";"La Florida";"70-74";3273;4346;7619
"1452";"La Florida";"75-80";3413;6981;10394
"1453";"La Granja";"20-24";6148;5968;12116
"1454";"La Granja";"25-29";5683;5555;11238
"1455";"La Granja";"30-34";4946;4767;9713
"1456";"La Granja";"35-39";5002;5179;10181
"1457";"La Granja";"40-44";5417;5680;11097
"1458";"La Granja";"45-49";5495;5445;10940
"1459";"La Granja";"50-54";5014;4939;9953
"1460";"La Granja";"55-59";3419;3533;6952
"1461";"La Granja";"60-64";2441;2843;5284
"1462";"La Granja";"65-69";2168;2704;4872
"1463";"La Granja";"70-74";1626;2199;3825
"1464";"La Granja";"75-80";1717;2810;4527
"1465";"La Higuera";"20-24";226;181;407
"1466";"La Higuera";"25-29";201;167;368
"1467";"La Higuera";"30-34";182;117;299
"1468";"La Higuera";"35-39";178;115;293
"1469";"La Higuera";"40-44";207;114;321
"1470";"La Higuera";"45-49";225;120;345
"1471";"La Higuera";"50-54";179;128;307
"1472";"La Higuera";"55-59";215;82;297
"1473";"La Higuera";"60-64";129;73;202
"1474";"La Higuera";"65-69";64;84;148
"1475";"La Higuera";"70-74";93;35;128
"1476";"La Higuera";"75-80";96;70;166
"1477";"La Ligua";"20-24";1177;1126;2303
"1478";"La Ligua";"25-29";1496;1471;2967
"1479";"La Ligua";"30-34";1318;1253;2571
"1480";"La Ligua";"35-39";1225;1241;2466
"1481";"La Ligua";"40-44";1116;1100;2216
"1482";"La Ligua";"45-49";1211;1164;2375
"1483";"La Ligua";"50-54";1088;1063;2151
"1484";"La Ligua";"55-59";946;910;1856
"1485";"La Ligua";"60-64";777;847;1624
"1486";"La Ligua";"65-69";633;644;1277
"1487";"La Ligua";"70-74";429;383;812
"1488";"La Ligua";"75-80";515;714;1229
"1489";"La Pintana";"20-24";10225;9382;19607
"1490";"La Pintana";"25-29";9050;8576;17626
"1491";"La Pintana";"30-34";7730;7169;14899
"1492";"La Pintana";"35-39";7195;7251;14446
"1493";"La Pintana";"40-44";7490;7678;15168
"1494";"La Pintana";"45-49";7750;8024;15774
"1495";"La Pintana";"50-54";7267;7000;14267
"1496";"La Pintana";"55-59";5024;5250;10274
"1497";"La Pintana";"60-64";3757;3661;7418
"1498";"La Pintana";"65-69";2337;2447;4784
"1499";"La Pintana";"70-74";1334;1522;2856
"1500";"La Pintana";"75-80";1179;2123;3302
"1501";"La Reina";"20-24";3957;4436;8393
"1502";"La Reina";"25-29";3415;3946;7361
"1503";"La Reina";"30-34";3014;3700;6714
"1504";"La Reina";"35-39";3178;3708;6886
"1505";"La Reina";"40-44";3233;3928;7161
"1506";"La Reina";"45-49";3649;4362;8011
"1507";"La Reina";"50-54";3579;4343;7922
"1508";"La Reina";"55-59";3013;3529;6542
"1509";"La Reina";"60-64";2202;2647;4849
"1510";"La Reina";"65-69";1684;2152;3836
"1511";"La Reina";"70-74";1175;1647;2822
"1512";"La Reina";"75-80";1647;3375;5022
"1513";"La Serena";"20-24";10449;9854;20303
"1514";"La Serena";"25-29";8275;8263;16538
"1515";"La Serena";"30-34";7108;7140;14248
"1516";"La Serena";"35-39";6803;6961;13764
"1517";"La Serena";"40-44";6936;7572;14508
"1518";"La Serena";"45-49";7006;7885;14891
"1519";"La Serena";"50-54";6395;7024;13419
"1520";"La Serena";"55-59";5250;5822;11072
"1521";"La Serena";"60-64";3828;4304;8132
"1522";"La Serena";"65-69";3043;3497;6540
"1523";"La Serena";"70-74";2291;2909;5200
"1524";"La Serena";"75-80";3243;5117;8360
"1525";"La Unión";"20-24";1693;1666;3359
"1526";"La Unión";"25-29";1805;1581;3386
"1527";"La Unión";"30-34";1445;1456;2901
"1528";"La Unión";"35-39";1366;1321;2687
"1529";"La Unión";"40-44";1497;1479;2976
"1530";"La Unión";"45-49";1614;1495;3109
"1531";"La Unión";"50-54";1584;1425;3009
"1532";"La Unión";"55-59";1251;1175;2426
"1533";"La Unión";"60-64";977;941;1918
"1534";"La Unión";"65-69";811;841;1652
"1535";"La Unión";"70-74";579;625;1204
"1536";"La Unión";"75-80";683;1068;1751
"1537";"Lago Ranco";"20-24";445;351;796
"1538";"Lago Ranco";"25-29";432;404;836
"1539";"Lago Ranco";"30-34";379;334;713
"1540";"Lago Ranco";"35-39";350;291;641
"1541";"Lago Ranco";"40-44";397;314;711
"1542";"Lago Ranco";"45-49";418;384;802
"1543";"Lago Ranco";"50-54";392;337;729
"1544";"Lago Ranco";"55-59";355;271;626
"1545";"Lago Ranco";"60-64";259;246;505
"1546";"Lago Ranco";"65-69";235;205;440
"1547";"Lago Ranco";"70-74";161;137;298
"1548";"Lago Ranco";"75-80";229;246;475
"1549";"Lago Verde";"20-24";52;48;100
"1550";"Lago Verde";"25-29";55;25;80
"1551";"Lago Verde";"30-34";44;27;71
"1552";"Lago Verde";"35-39";50;35;85
"1553";"Lago Verde";"40-44";48;30;78
"1554";"Lago Verde";"45-49";65;22;87
"1555";"Lago Verde";"50-54";49;31;80
"1556";"Lago Verde";"55-59";50;29;79
"1557";"Lago Verde";"60-64";30;10;40
"1558";"Lago Verde";"65-69";22;16;38
"1559";"Lago Verde";"70-74";15;12;27
"1560";"Lago Verde";"75-80";23;10;33
"1561";"Laguna Blanca";"20-24";50;5;55
"1562";"Laguna Blanca";"25-29";28;7;35
"1563";"Laguna Blanca";"30-34";50;2;52
"1564";"Laguna Blanca";"35-39";36;7;43
"1565";"Laguna Blanca";"40-44";36;2;38
"1566";"Laguna Blanca";"45-49";33;3;36
"1567";"Laguna Blanca";"50-54";49;4;53
"1568";"Laguna Blanca";"55-59";29;4;33
"1569";"Laguna Blanca";"60-64";24;2;26
"1570";"Laguna Blanca";"65-69";21;2;23
"1571";"Laguna Blanca";"70-74";2;1;3
"1572";"Laguna Blanca";"75-80";12;0;12
"1573";"Laja";"20-24";936;918;1854
"1574";"Laja";"25-29";862;923;1785
"1575";"Laja";"30-34";762;842;1604
"1576";"Laja";"35-39";732;780;1512
"1577";"Laja";"40-44";780;845;1625
"1578";"Laja";"45-49";868;930;1798
"1579";"Laja";"50-54";853;884;1737
"1580";"Laja";"55-59";796;749;1545
"1581";"Laja";"60-64";602;578;1180
"1582";"Laja";"65-69";438;434;872
"1583";"Laja";"70-74";302;349;651
"1584";"Laja";"75-80";380;522;902
"1585";"Lampa";"20-24";3139;3073;6212
"1586";"Lampa";"25-29";3094;2990;6084
"1587";"Lampa";"30-34";3219;3180;6399
"1588";"Lampa";"35-39";3180;2998;6178
"1589";"Lampa";"40-44";2968;2539;5507
"1590";"Lampa";"45-49";2758;2435;5193
"1591";"Lampa";"50-54";2249;1934;4183
"1592";"Lampa";"55-59";1755;1649;3404
"1593";"Lampa";"60-64";1444;1222;2666
"1594";"Lampa";"65-69";1120;1040;2160
"1595";"Lampa";"70-74";719;673;1392
"1596";"Lampa";"75-80";1138;1036;2174
"1597";"Lanco";"20-24";628;653;1281
"1598";"Lanco";"25-29";662;654;1316
"1599";"Lanco";"30-34";639;611;1250
"1600";"Lanco";"35-39";497;544;1041
"1601";"Lanco";"40-44";568;545;1113
"1602";"Lanco";"45-49";669;618;1287
"1603";"Lanco";"50-54";553;539;1092
"1604";"Lanco";"55-59";448;408;856
"1605";"Lanco";"60-64";377;394;771
"1606";"Lanco";"65-69";281;336;617
"1607";"Lanco";"70-74";258;303;561
"1608";"Lanco";"75-80";363;460;823
"1609";"Las Cabras";"20-24";972;896;1868
"1610";"Las Cabras";"25-29";841;776;1617
"1611";"Las Cabras";"30-34";802;728;1530
"1612";"Las Cabras";"35-39";887;812;1699
"1613";"Las Cabras";"40-44";904;838;1742
"1614";"Las Cabras";"45-49";948;745;1693
"1615";"Las Cabras";"50-54";836;784;1620
"1616";"Las Cabras";"55-59";724;620;1344
"1617";"Las Cabras";"60-64";642;546;1188
"1618";"Las Cabras";"65-69";528;447;975
"1619";"Las Cabras";"70-74";356;322;678
"1620";"Las Cabras";"75-80";520;516;1036
"1621";"Las Condes";"20-24";10835;13036;23871
"1622";"Las Condes";"25-29";10589;13444;24033
"1623";"Las Condes";"30-34";9628;11367;20995
"1624";"Las Condes";"35-39";7953;9662;17615
"1625";"Las Condes";"40-44";7941;10097;18038
"1626";"Las Condes";"45-49";8814;11819;20633
"1627";"Las Condes";"50-54";8925;12026;20951
"1628";"Las Condes";"55-59";7971;11129;19100
"1629";"Las Condes";"60-64";6639;8613;15252
"1630";"Las Condes";"65-69";5393;7027;12420
"1631";"Las Condes";"70-74";3812;5159;8971
"1632";"Las Condes";"75-80";5533;10502;16035
"1633";"Lautaro";"20-24";1578;1481;3059
"1634";"Lautaro";"25-29";1463;1538;3001
"1635";"Lautaro";"30-34";1144;1243;2387
"1636";"Lautaro";"35-39";1084;1131;2215
"1637";"Lautaro";"40-44";1167;1274;2441
"1638";"Lautaro";"45-49";1226;1242;2468
"1639";"Lautaro";"50-54";1090;1128;2218
"1640";"Lautaro";"55-59";1004;1003;2007
"1641";"Lautaro";"60-64";739;796;1535
"1642";"Lautaro";"65-69";548;628;1176
"1643";"Lautaro";"70-74";468;562;1030
"1644";"Lautaro";"75-80";651;895;1546
"1645";"Lebu";"20-24";1151;1137;2288
"1646";"Lebu";"25-29";1076;1136;2212
"1647";"Lebu";"30-34";915;951;1866
"1648";"Lebu";"35-39";839;811;1650
"1649";"Lebu";"40-44";868;921;1789
"1650";"Lebu";"45-49";907;966;1873
"1651";"Lebu";"50-54";808;847;1655
"1652";"Lebu";"55-59";652;659;1311
"1653";"Lebu";"60-64";524;492;1016
"1654";"Lebu";"65-69";469;398;867
"1655";"Lebu";"70-74";352;367;719
"1656";"Lebu";"75-80";467;480;947
"1657";"Licantén";"20-24";303;262;565
"1658";"Licantén";"25-29";274;229;503
"1659";"Licantén";"30-34";287;222;509
"1660";"Licantén";"35-39";302;249;551
"1661";"Licantén";"40-44";278;244;522
"1662";"Licantén";"45-49";293;256;549
"1663";"Licantén";"50-54";273;209;482
"1664";"Licantén";"55-59";249;158;407
"1665";"Licantén";"60-64";171;161;332
"1666";"Licantén";"65-69";126;128;254
"1667";"Licantén";"70-74";101;100;201
"1668";"Licantén";"75-80";171;249;420
"1669";"Limache";"20-24";1924;1839;3763
"1670";"Limache";"25-29";1947;1840;3787
"1671";"Limache";"30-34";1638;1539;3177
"1672";"Limache";"35-39";1426;1453;2879
"1673";"Limache";"40-44";1343;1379;2722
"1674";"Limache";"45-49";1370;1504;2874
"1675";"Limache";"50-54";1436;1507;2943
"1676";"Limache";"55-59";1240;1342;2582
"1677";"Limache";"60-64";1078;1090;2168
"1678";"Limache";"65-69";854;943;1797
"1679";"Limache";"70-74";583;726;1309
"1680";"Limache";"75-80";838;1415;2253
"1681";"Linares";"20-24";3839;3808;7647
"1682";"Linares";"25-29";3040;3237;6277
"1683";"Linares";"30-34";2668;2898;5566
"1684";"Linares";"35-39";2980;3177;6157
"1685";"Linares";"40-44";3091;3479;6570
"1686";"Linares";"45-49";3189;3574;6763
"1687";"Linares";"50-54";2939;3237;6176
"1688";"Linares";"55-59";2397;2742;5139
"1689";"Linares";"60-64";1966;2193;4159
"1690";"Linares";"65-69";1640;1805;3445
"1691";"Linares";"70-74";1158;1403;2561
"1692";"Linares";"75-80";1462;2149;3611
"1693";"Litueche";"20-24";212;169;381
"1694";"Litueche";"25-29";191;200;391
"1695";"Litueche";"30-34";181;198;379
"1696";"Litueche";"35-39";215;191;406
"1697";"Litueche";"40-44";254;233;487
"1698";"Litueche";"45-49";250;210;460
"1699";"Litueche";"50-54";267;212;479
"1700";"Litueche";"55-59";211;157;368
"1701";"Litueche";"60-64";168;136;304
"1702";"Litueche";"65-69";136;131;267
"1703";"Litueche";"70-74";98;90;188
"1704";"Litueche";"75-80";153;196;349
"1705";"Llaillay";"20-24";895;990;1885
"1706";"Llaillay";"25-29";1084;1026;2110
"1707";"Llaillay";"30-34";931;937;1868
"1708";"Llaillay";"35-39";852;736;1588
"1709";"Llaillay";"40-44";800;735;1535
"1710";"Llaillay";"45-49";853;862;1715
"1711";"Llaillay";"50-54";803;769;1572
"1712";"Llaillay";"55-59";635;677;1312
"1713";"Llaillay";"60-64";511;491;1002
"1714";"Llaillay";"65-69";449;409;858
"1715";"Llaillay";"70-74";299;352;651
"1716";"Llaillay";"75-80";442;567;1009
"1717";"Llanquihue";"20-24";695;677;1372
"1718";"Llanquihue";"25-29";677;651;1328
"1719";"Llanquihue";"30-34";567;611;1178
"1720";"Llanquihue";"35-39";659;693;1352
"1721";"Llanquihue";"40-44";704;639;1343
"1722";"Llanquihue";"45-49";732;705;1437
"1723";"Llanquihue";"50-54";607;564;1171
"1724";"Llanquihue";"55-59";485;470;955
"1725";"Llanquihue";"60-64";387;394;781
"1726";"Llanquihue";"65-69";262;252;514
"1727";"Llanquihue";"70-74";193;224;417
"1728";"Llanquihue";"75-80";240;357;597
"1729";"Lo Barnechea";"20-24";3963;4905;8868
"1730";"Lo Barnechea";"25-29";3243;4276;7519
"1731";"Lo Barnechea";"30-34";3035;4403;7438
"1732";"Lo Barnechea";"35-39";3698;4320;8018
"1733";"Lo Barnechea";"40-44";3741;4491;8232
"1734";"Lo Barnechea";"45-49";4010;4361;8371
"1735";"Lo Barnechea";"50-54";3326;3416;6742
"1736";"Lo Barnechea";"55-59";2189;2347;4536
"1737";"Lo Barnechea";"60-64";1427;1459;2886
"1738";"Lo Barnechea";"65-69";967;945;1912
"1739";"Lo Barnechea";"70-74";619;627;1246
"1740";"Lo Barnechea";"75-80";685;1128;1813
"1741";"Lo Espejo";"20-24";4786;4582;9368
"1742";"Lo Espejo";"25-29";4533;4300;8833
"1743";"Lo Espejo";"30-34";4475;4197;8672
"1744";"Lo Espejo";"35-39";4440;4245;8685
"1745";"Lo Espejo";"40-44";4686;4322;9008
"1746";"Lo Espejo";"45-49";4160;3992;8152
"1747";"Lo Espejo";"50-54";3564;3637;7201
"1748";"Lo Espejo";"55-59";2860;3031;5891
"1749";"Lo Espejo";"60-64";2304;2776;5080
"1750";"Lo Espejo";"65-69";2034;2799;4833
"1751";"Lo Espejo";"70-74";1768;2265;4033
"1752";"Lo Espejo";"75-80";1706;2755;4461
"1753";"Lo Prado";"20-24";4701;4570;9271
"1754";"Lo Prado";"25-29";5430;5141;10571
"1755";"Lo Prado";"30-34";4805;4467;9272
"1756";"Lo Prado";"35-39";3910;3762;7672
"1757";"Lo Prado";"40-44";3306;3272;6578
"1758";"Lo Prado";"45-49";3224;3559;6783
"1759";"Lo Prado";"50-54";3712;4368;8080
"1760";"Lo Prado";"55-59";3574;4168;7742
"1761";"Lo Prado";"60-64";3017;3366;6383
"1762";"Lo Prado";"65-69";2182;2495;4677
"1763";"Lo Prado";"70-74";1245;1560;2805
"1764";"Lo Prado";"75-80";1176;2258;3434
"1765";"Lolol";"20-24";278;217;495
"1766";"Lolol";"25-29";230;194;424
"1767";"Lolol";"30-34";225;179;404
"1768";"Lolol";"35-39";239;182;421
"1769";"Lolol";"40-44";222;222;444
"1770";"Lolol";"45-49";285;235;520
"1771";"Lolol";"50-54";277;218;495
"1772";"Lolol";"55-59";243;229;472
"1773";"Lolol";"60-64";228;175;403
"1774";"Lolol";"65-69";153;163;316
"1775";"Lolol";"70-74";120;141;261
"1776";"Lolol";"75-80";201;254;455
"1777";"Loncoche";"20-24";910;891;1801
"1778";"Loncoche";"25-29";813;859;1672
"1779";"Loncoche";"30-34";716;741;1457
"1780";"Loncoche";"35-39";740;771;1511
"1781";"Loncoche";"40-44";821;835;1656
"1782";"Loncoche";"45-49";811;803;1614
"1783";"Loncoche";"50-54";841;772;1613
"1784";"Loncoche";"55-59";690;631;1321
"1785";"Loncoche";"60-64";555;589;1144
"1786";"Loncoche";"65-69";442;458;900
"1787";"Loncoche";"70-74";369;427;796
"1788";"Loncoche";"75-80";552;686;1238
"1789";"Longaví";"20-24";1315;1176;2491
"1790";"Longaví";"25-29";1019;1069;2088
"1791";"Longaví";"30-34";933;890;1823
"1792";"Longaví";"35-39";1065;965;2030
"1793";"Longaví";"40-44";1121;997;2118
"1794";"Longaví";"45-49";1149;982;2131
"1795";"Longaví";"50-54";1038;927;1965
"1796";"Longaví";"55-59";911;824;1735
"1797";"Longaví";"60-64";776;629;1405
"1798";"Longaví";"65-69";591;453;1044
"1799";"Longaví";"70-74";412;377;789
"1800";"Longaví";"75-80";548;663;1211
"1801";"Lonquimay";"20-24";461;392;853
"1802";"Lonquimay";"25-29";466;436;902
"1803";"Lonquimay";"30-34";373;345;718
"1804";"Lonquimay";"35-39";343;339;682
"1805";"Lonquimay";"40-44";406;331;737
"1806";"Lonquimay";"45-49";422;371;793
"1807";"Lonquimay";"50-54";380;284;664
"1808";"Lonquimay";"55-59";283;283;566
"1809";"Lonquimay";"60-64";231;206;437
"1810";"Lonquimay";"65-69";196;183;379
"1811";"Lonquimay";"70-74";119;109;228
"1812";"Lonquimay";"75-80";204;260;464
"1813";"Los Álamos";"20-24";1045;1002;2047
"1814";"Los Álamos";"25-29";910;882;1792
"1815";"Los Álamos";"30-34";772;770;1542
"1816";"Los Álamos";"35-39";697;694;1391
"1817";"Los Álamos";"40-44";713;754;1467
"1818";"Los Álamos";"45-49";796;787;1583
"1819";"Los Álamos";"50-54";709;684;1393
"1820";"Los Álamos";"55-59";510;551;1061
"1821";"Los Álamos";"60-64";467;405;872
"1822";"Los Álamos";"65-69";391;383;774
"1823";"Los Álamos";"70-74";320;298;618
"1824";"Los Álamos";"75-80";439;488;927
"1825";"Los Andes";"20-24";2652;2552;5204
"1826";"Los Andes";"25-29";3043;2871;5914
"1827";"Los Andes";"30-34";2621;2488;5109
"1828";"Los Andes";"35-39";2196;2169;4365
"1829";"Los Andes";"40-44";2155;2284;4439
"1830";"Los Andes";"45-49";2477;2616;5093
"1831";"Los Andes";"50-54";2425;2419;4844
"1832";"Los Andes";"55-59";1917;1835;3752
"1833";"Los Andes";"60-64";1254;1295;2549
"1834";"Los Andes";"65-69";915;1125;2040
"1835";"Los Andes";"70-74";664;872;1536
"1836";"Los Andes";"75-80";995;1655;2650
"1837";"Los Ángeles";"20-24";7792;8240;16032
"1838";"Los Ángeles";"25-29";7728;8176;15904
"1839";"Los Ángeles";"30-34";6775;7311;14086
"1840";"Los Ángeles";"35-39";6139;6557;12696
"1841";"Los Ángeles";"40-44";6507;7022;13529
"1842";"Los Ángeles";"45-49";6598;6787;13385
"1843";"Los Ángeles";"50-54";5954;6206;12160
"1844";"Los Ángeles";"55-59";5041;5045;10086
"1845";"Los Ángeles";"60-64";3967;3895;7862
"1846";"Los Ángeles";"65-69";3029;3490;6519
"1847";"Los Ángeles";"70-74";2213;2477;4690
"1848";"Los Ángeles";"75-80";2952;4200;7152
"1849";"Los Lagos";"20-24";910;862;1772
"1850";"Los Lagos";"25-29";1024;904;1928
"1851";"Los Lagos";"30-34";780;676;1456
"1852";"Los Lagos";"35-39";651;695;1346
"1853";"Los Lagos";"40-44";724;742;1466
"1854";"Los Lagos";"45-49";875;721;1596
"1855";"Los Lagos";"50-54";742;670;1412
"1856";"Los Lagos";"55-59";635;558;1193
"1857";"Los Lagos";"60-64";471;492;963
"1858";"Los Lagos";"65-69";394;386;780
"1859";"Los Lagos";"70-74";262;306;568
"1860";"Los Lagos";"75-80";373;485;858
"1861";"Los Muermos";"20-24";617;519;1136
"1862";"Los Muermos";"25-29";580;499;1079
"1863";"Los Muermos";"30-34";551;487;1038
"1864";"Los Muermos";"35-39";624;543;1167
"1865";"Los Muermos";"40-44";671;609;1280
"1866";"Los Muermos";"45-49";716;570;1286
"1867";"Los Muermos";"50-54";713;528;1241
"1868";"Los Muermos";"55-59";562;454;1016
"1869";"Los Muermos";"60-64";467;401;868
"1870";"Los Muermos";"65-69";338;306;644
"1871";"Los Muermos";"70-74";251;238;489
"1872";"Los Muermos";"75-80";299;395;694
"1873";"Los Sauces";"20-24";311;291;602
"1874";"Los Sauces";"25-29";257;262;519
"1875";"Los Sauces";"30-34";236;240;476
"1876";"Los Sauces";"35-39";266;227;493
"1877";"Los Sauces";"40-44";283;270;553
"1878";"Los Sauces";"45-49";306;272;578
"1879";"Los Sauces";"50-54";273;266;539
"1880";"Los Sauces";"55-59";234;235;469
"1881";"Los Sauces";"60-64";209;189;398
"1882";"Los Sauces";"65-69";165;153;318
"1883";"Los Sauces";"70-74";143;142;285
"1884";"Los Sauces";"75-80";180;247;427
"1885";"Los Vilos";"20-24";753;767;1520
"1886";"Los Vilos";"25-29";720;768;1488
"1887";"Los Vilos";"30-34";707;609;1316
"1888";"Los Vilos";"35-39";725;687;1412
"1889";"Los Vilos";"40-44";748;708;1456
"1890";"Los Vilos";"45-49";744;642;1386
"1891";"Los Vilos";"50-54";682;559;1241
"1892";"Los Vilos";"55-59";502;561;1063
"1893";"Los Vilos";"60-64";466;413;879
"1894";"Los Vilos";"65-69";365;396;761
"1895";"Los Vilos";"70-74";265;267;532
"1896";"Los Vilos";"75-80";356;436;792
"1897";"Lota";"20-24";2178;2225;4403
"1898";"Lota";"25-29";2051;1963;4014
"1899";"Lota";"30-34";1704;1689;3393
"1900";"Lota";"35-39";1551;1663;3214
"1901";"Lota";"40-44";1671;1665;3336
"1902";"Lota";"45-49";1731;1834;3565
"1903";"Lota";"50-54";1594;1568;3162
"1904";"Lota";"55-59";1367;1371;2738
"1905";"Lota";"60-64";1035;1094;2129
"1906";"Lota";"65-69";688;829;1517
"1907";"Lota";"70-74";616;736;1352
"1908";"Lota";"75-80";810;1054;1864
"1909";"Lumaco";"20-24";487;390;877
"1910";"Lumaco";"25-29";493;357;850
"1911";"Lumaco";"30-34";424;329;753
"1912";"Lumaco";"35-39";438;326;764
"1913";"Lumaco";"40-44";443;328;771
"1914";"Lumaco";"45-49";407;322;729
"1915";"Lumaco";"50-54";484;322;806
"1916";"Lumaco";"55-59";369;295;664
"1917";"Lumaco";"60-64";300;231;531
"1918";"Lumaco";"65-69";249;179;428
"1919";"Lumaco";"70-74";180;143;323
"1920";"Lumaco";"75-80";246;252;498
"1921";"Machalí";"20-24";1935;2015;3950
"1922";"Machalí";"25-29";1684;1738;3422
"1923";"Machalí";"30-34";1581;1644;3225
"1924";"Machalí";"35-39";1763;1804;3567
"1925";"Machalí";"40-44";1936;1946;3882
"1926";"Machalí";"45-49";1937;1832;3769
"1927";"Machalí";"50-54";1742;1656;3398
"1928";"Machalí";"55-59";1288;1314;2602
"1929";"Machalí";"60-64";893;938;1831
"1930";"Machalí";"65-69";717;783;1500
"1931";"Machalí";"70-74";467;565;1032
"1932";"Machalí";"75-80";550;943;1493
"1933";"Macul";"20-24";5176;4916;10092
"1934";"Macul";"25-29";5320;5101;10421
"1935";"Macul";"30-34";4661;4435;9096
"1936";"Macul";"35-39";4019;4032;8051
"1937";"Macul";"40-44";3874;4222;8096
"1938";"Macul";"45-49";4109;4659;8768
"1939";"Macul";"50-54";4127;4856;8983
"1940";"Macul";"55-59";3693;4376;8069
"1941";"Macul";"60-64";3105;3849;6954
"1942";"Macul";"65-69";2381;3002;5383
"1943";"Macul";"70-74";1633;2216;3849
"1944";"Macul";"75-80";2011;3894;5905
"1945";"Máfil";"20-24";314;263;577
"1946";"Máfil";"25-29";253;258;511
"1947";"Máfil";"30-34";242;229;471
"1948";"Máfil";"35-39";252;225;477
"1949";"Máfil";"40-44";242;217;459
"1950";"Máfil";"45-49";295;221;516
"1951";"Máfil";"50-54";264;216;480
"1952";"Máfil";"55-59";220;218;438
"1953";"Máfil";"60-64";178;159;337
"1954";"Máfil";"65-69";137;157;294
"1955";"Máfil";"70-74";124;106;230
"1956";"Máfil";"75-80";189;211;400
"1957";"Maipú";"20-24";21408;20996;42404
"1958";"Maipú";"25-29";20561;21915;42476
"1959";"Maipú";"30-34";21496;23222;44718
"1960";"Maipú";"35-39";23020;24298;47318
"1961";"Maipú";"40-44";22705;23517;46222
"1962";"Maipú";"45-49";20520;21393;41913
"1963";"Maipú";"50-54";17358;18412;35770
"1964";"Maipú";"55-59";12029;13053;25082
"1965";"Maipú";"60-64";8172;9167;17339
"1966";"Maipú";"65-69";5556;6655;12211
"1967";"Maipú";"70-74";3372;4772;8144
"1968";"Maipú";"75-80";3372;6775;10147
"1969";"Malloa";"20-24";620;544;1164
"1970";"Malloa";"25-29";439;447;886
"1971";"Malloa";"30-34";440;379;819
"1972";"Malloa";"35-39";506;472;978
"1973";"Malloa";"40-44";500;481;981
"1974";"Malloa";"45-49";547;464;1011
"1975";"Malloa";"50-54";524;426;950
"1976";"Malloa";"55-59";444;372;816
"1977";"Malloa";"60-64";324;319;643
"1978";"Malloa";"65-69";272;228;500
"1979";"Malloa";"70-74";162;194;356
"1980";"Malloa";"75-80";264;320;584
"1981";"Marchihue";"20-24";280;247;527
"1982";"Marchihue";"25-29";257;249;506
"1983";"Marchihue";"30-34";237;229;466
"1984";"Marchihue";"35-39";268;226;494
"1985";"Marchihue";"40-44";282;267;549
"1986";"Marchihue";"45-49";295;256;551
"1987";"Marchihue";"50-54";310;280;590
"1988";"Marchihue";"55-59";259;230;489
"1989";"Marchihue";"60-64";253;178;431
"1990";"Marchihue";"65-69";162;121;283
"1991";"Marchihue";"70-74";114;134;248
"1992";"Marchihue";"75-80";180;241;421
"1993";"María Elena";"20-24";217;183;400
"1994";"María Elena";"25-29";302;198;500
"1995";"María Elena";"30-34";260;209;469
"1996";"María Elena";"35-39";297;202;499
"1997";"María Elena";"40-44";271;162;433
"1998";"María Elena";"45-49";308;189;497
"1999";"María Elena";"50-54";278;145;423
"2000";"María Elena";"55-59";203;92;295
"2001";"María Elena";"60-64";117;46;163
"2002";"María Elena";"65-69";32;27;59
"2003";"María Elena";"70-74";17;20;37
"2004";"María Elena";"75-80";22;20;42
"2005";"María Pinto";"20-24";491;499;990
"2006";"María Pinto";"25-29";467;471;938
"2007";"María Pinto";"30-34";465;476;941
"2008";"María Pinto";"35-39";494;468;962
"2009";"María Pinto";"40-44";493;412;905
"2010";"María Pinto";"45-49";410;460;870
"2011";"María Pinto";"50-54";402;333;735
"2012";"María Pinto";"55-59";335;293;628
"2013";"María Pinto";"60-64";265;277;542
"2014";"María Pinto";"65-69";279;239;518
"2015";"María Pinto";"70-74";159;136;295
"2016";"María Pinto";"75-80";239;240;479
"2017";"Mariquina";"20-24";870;900;1770
"2018";"Mariquina";"25-29";905;861;1766
"2019";"Mariquina";"30-34";764;727;1491
"2020";"Mariquina";"35-39";674;576;1250
"2021";"Mariquina";"40-44";710;659;1369
"2022";"Mariquina";"45-49";805;644;1449
"2023";"Mariquina";"50-54";728;674;1402
"2024";"Mariquina";"55-59";641;560;1201
"2025";"Mariquina";"60-64";492;461;953
"2026";"Mariquina";"65-69";411;375;786
"2027";"Mariquina";"70-74";264;276;540
"2028";"Mariquina";"75-80";441;591;1032
"2029";"Maule";"20-24";1783;1912;3695
"2030";"Maule";"25-29";1459;1512;2971
"2031";"Maule";"30-34";1312;1551;2863
"2032";"Maule";"35-39";1414;1503;2917
"2033";"Maule";"40-44";1518;1557;3075
"2034";"Maule";"45-49";1588;1410;2998
"2035";"Maule";"50-54";1326;1376;2702
"2036";"Maule";"55-59";1072;1066;2138
"2037";"Maule";"60-64";906;846;1752
"2038";"Maule";"65-69";790;751;1541
"2039";"Maule";"70-74";573;533;1106
"2040";"Maule";"75-80";720;817;1537
"2041";"Maullín";"20-24";501;441;942
"2042";"Maullín";"25-29";519;491;1010
"2043";"Maullín";"30-34";536;482;1018
"2044";"Maullín";"35-39";609;540;1149
"2045";"Maullín";"40-44";656;560;1216
"2046";"Maullín";"45-49";677;550;1227
"2047";"Maullín";"50-54";652;491;1143
"2048";"Maullín";"55-59";535;406;941
"2049";"Maullín";"60-64";417;364;781
"2050";"Maullín";"65-69";343;315;658
"2051";"Maullín";"70-74";232;228;460
"2052";"Maullín";"75-80";296;400;696
"2053";"Mejillones";"20-24";452;436;888
"2054";"Mejillones";"25-29";491;363;854
"2055";"Mejillones";"30-34";457;393;850
"2056";"Mejillones";"35-39";527;406;933
"2057";"Mejillones";"40-44";546;364;910
"2058";"Mejillones";"45-49";473;323;796
"2059";"Mejillones";"50-54";380;274;654
"2060";"Mejillones";"55-59";312;249;561
"2061";"Mejillones";"60-64";244;180;424
"2062";"Mejillones";"65-69";131;116;247
"2063";"Mejillones";"70-74";81;70;151
"2064";"Mejillones";"75-80";96;128;224
"2065";"Melipeuco";"20-24";213;160;373
"2066";"Melipeuco";"25-29";209;229;438
"2067";"Melipeuco";"30-34";144;196;340
"2068";"Melipeuco";"35-39";168;152;320
"2069";"Melipeuco";"40-44";213;189;402
"2070";"Melipeuco";"45-49";191;202;393
"2071";"Melipeuco";"50-54";209;191;400
"2072";"Melipeuco";"55-59";233;149;382
"2073";"Melipeuco";"60-64";159;163;322
"2074";"Melipeuco";"65-69";120;121;241
"2075";"Melipeuco";"70-74";120;95;215
"2076";"Melipeuco";"75-80";150;209;359
"2077";"Melipilla";"20-24";4677;4460;9137
"2078";"Melipilla";"25-29";4346;4463;8809
"2079";"Melipilla";"30-34";4252;4032;8284
"2080";"Melipilla";"35-39";4113;4005;8118
"2081";"Melipilla";"40-44";4056;4000;8056
"2082";"Melipilla";"45-49";3902;3854;7756
"2083";"Melipilla";"50-54";3799;3737;7536
"2084";"Melipilla";"55-59";3021;2832;5853
"2085";"Melipilla";"60-64";2570;2517;5087
"2086";"Melipilla";"65-69";2136;1902;4038
"2087";"Melipilla";"70-74";1404;1398;2802
"2088";"Melipilla";"75-80";1711;2294;4005
"2089";"Molina";"20-24";2056;1992;4048
"2090";"Molina";"25-29";1620;1562;3182
"2091";"Molina";"30-34";1285;1249;2534
"2092";"Molina";"35-39";1438;1470;2908
"2093";"Molina";"40-44";1520;1494;3014
"2094";"Molina";"45-49";1631;1591;3222
"2095";"Molina";"50-54";1466;1537;3003
"2096";"Molina";"55-59";1203;1183;2386
"2097";"Molina";"60-64";954;975;1929
"2098";"Molina";"65-69";741;738;1479
"2099";"Molina";"70-74";542;601;1143
"2100";"Molina";"75-80";741;966;1707
"2101";"Monte Patria";"20-24";1476;1363;2839
"2102";"Monte Patria";"25-29";1332;1334;2666
"2103";"Monte Patria";"30-34";1292;1185;2477
"2104";"Monte Patria";"35-39";1179;1069;2248
"2105";"Monte Patria";"40-44";1151;1057;2208
"2106";"Monte Patria";"45-49";1105;943;2048
"2107";"Monte Patria";"50-54";985;870;1855
"2108";"Monte Patria";"55-59";941;819;1760
"2109";"Monte Patria";"60-64";756;763;1519
"2110";"Monte Patria";"65-69";603;575;1178
"2111";"Monte Patria";"70-74";475;493;968
"2112";"Monte Patria";"75-80";614;888;1502
"2113";"Mostazal";"20-24";1241;1246;2487
"2114";"Mostazal";"25-29";1134;1061;2195
"2115";"Mostazal";"30-34";867;800;1667
"2116";"Mostazal";"35-39";872;894;1766
"2117";"Mostazal";"40-44";889;950;1839
"2118";"Mostazal";"45-49";1019;857;1876
"2119";"Mostazal";"50-54";897;805;1702
"2120";"Mostazal";"55-59";696;666;1362
"2121";"Mostazal";"60-64";596;543;1139
"2122";"Mostazal";"65-69";403;422;825
"2123";"Mostazal";"70-74";303;300;603
"2124";"Mostazal";"75-80";395;470;865
"2125";"Mulchén";"20-24";1312;1208;2520
"2126";"Mulchén";"25-29";1133;1119;2252
"2127";"Mulchén";"30-34";991;951;1942
"2128";"Mulchén";"35-39";931;904;1835
"2129";"Mulchén";"40-44";1028;972;2000
"2130";"Mulchén";"45-49";1044;1036;2080
"2131";"Mulchén";"50-54";1025;928;1953
"2132";"Mulchén";"55-59";920;805;1725
"2133";"Mulchén";"60-64";719;711;1430
"2134";"Mulchén";"65-69";586;639;1225
"2135";"Mulchén";"70-74";453;508;961
"2136";"Mulchén";"75-80";637;743;1380
"2137";"Nacimiento";"20-24";1155;1141;2296
"2138";"Nacimiento";"25-29";1090;1185;2275
"2139";"Nacimiento";"30-34";948;969;1917
"2140";"Nacimiento";"35-39";948;897;1845
"2141";"Nacimiento";"40-44";1043;965;2008
"2142";"Nacimiento";"45-49";1065;953;2018
"2143";"Nacimiento";"50-54";896;811;1707
"2144";"Nacimiento";"55-59";816;738;1554
"2145";"Nacimiento";"60-64";641;600;1241
"2146";"Nacimiento";"65-69";510;494;1004
"2147";"Nacimiento";"70-74";363;358;721
"2148";"Nacimiento";"75-80";483;626;1109
"2149";"Nancagua";"20-24";712;681;1393
"2150";"Nancagua";"25-29";562;585;1147
"2151";"Nancagua";"30-34";546;486;1032
"2152";"Nancagua";"35-39";625;677;1302
"2153";"Nancagua";"40-44";598;553;1151
"2154";"Nancagua";"45-49";653;549;1202
"2155";"Nancagua";"50-54";525;556;1081
"2156";"Nancagua";"55-59";531;478;1009
"2157";"Nancagua";"60-64";401;379;780
"2158";"Nancagua";"65-69";317;317;634
"2159";"Nancagua";"70-74";248;253;501
"2160";"Nancagua";"75-80";309;386;695
"2161";"Natales";"20-24";676;699;1375
"2162";"Natales";"25-29";971;746;1717
"2163";"Natales";"30-34";818;689;1507
"2164";"Natales";"35-39";746;693;1439
"2165";"Natales";"40-44";679;614;1293
"2166";"Natales";"45-49";800;747;1547
"2167";"Natales";"50-54";897;792;1689
"2168";"Natales";"55-59";764;696;1460
"2169";"Natales";"60-64";597;487;1084
"2170";"Natales";"65-69";420;416;836
"2171";"Natales";"70-74";326;339;665
"2172";"Natales";"75-80";364;525;889
"2173";"Navidad";"20-24";168;168;336
"2174";"Navidad";"25-29";159;124;283
"2175";"Navidad";"30-34";163;142;305
"2176";"Navidad";"35-39";177;178;355
"2177";"Navidad";"40-44";241;195;436
"2178";"Navidad";"45-49";255;179;434
"2179";"Navidad";"50-54";237;193;430
"2180";"Navidad";"55-59";236;208;444
"2181";"Navidad";"60-64";215;217;432
"2182";"Navidad";"65-69";225;166;391
"2183";"Navidad";"70-74";134;136;270
"2184";"Navidad";"75-80";227;222;449
"2185";"Negrete";"20-24";399;372;771
"2186";"Negrete";"25-29";360;432;792
"2187";"Negrete";"30-34";362;336;698
"2188";"Negrete";"35-39";294;309;603
"2189";"Negrete";"40-44";349;308;657
"2190";"Negrete";"45-49";363;310;673
"2191";"Negrete";"50-54";293;291;584
"2192";"Negrete";"55-59";306;276;582
"2193";"Negrete";"60-64";252;235;487
"2194";"Negrete";"65-69";197;189;386
"2195";"Negrete";"70-74";148;136;284
"2196";"Negrete";"75-80";227;218;445
"2197";"Ninhue";"20-24";188;177;365
"2198";"Ninhue";"25-29";186;166;352
"2199";"Ninhue";"30-34";174;182;356
"2200";"Ninhue";"35-39";176;172;348
"2201";"Ninhue";"40-44";203;192;395
"2202";"Ninhue";"45-49";240;191;431
"2203";"Ninhue";"50-54";232;231;463
"2204";"Ninhue";"55-59";183;179;362
"2205";"Ninhue";"60-64";223;140;363
"2206";"Ninhue";"65-69";138;154;292
"2207";"Ninhue";"70-74";108;121;229
"2208";"Ninhue";"75-80";164;198;362
"2209";"Nogales";"20-24";895;994;1889
"2210";"Nogales";"25-29";1046;1081;2127
"2211";"Nogales";"30-34";915;862;1777
"2212";"Nogales";"35-39";808;750;1558
"2213";"Nogales";"40-44";813;716;1529
"2214";"Nogales";"45-49";808;756;1564
"2215";"Nogales";"50-54";742;770;1512
"2216";"Nogales";"55-59";646;650;1296
"2217";"Nogales";"60-64";498;505;1003
"2218";"Nogales";"65-69";381;390;771
"2219";"Nogales";"70-74";289;316;605
"2220";"Nogales";"75-80";383;544;927
"2221";"Nueva Imperial";"20-24";1359;1296;2655
"2222";"Nueva Imperial";"25-29";1199;1157;2356
"2223";"Nueva Imperial";"30-34";980;939;1919
"2224";"Nueva Imperial";"35-39";1025;997;2022
"2225";"Nueva Imperial";"40-44";1177;1097;2274
"2226";"Nueva Imperial";"45-49";1196;1107;2303
"2227";"Nueva Imperial";"50-54";1196;973;2169
"2228";"Nueva Imperial";"55-59";931;843;1774
"2229";"Nueva Imperial";"60-64";733;702;1435
"2230";"Nueva Imperial";"65-69";652;743;1395
"2231";"Nueva Imperial";"70-74";436;545;981
"2232";"Nueva Imperial";"75-80";707;1065;1772
"2233";"Ñiquén";"20-24";379;357;736
"2234";"Ñiquén";"25-29";348;349;697
"2235";"Ñiquén";"30-34";346;370;716
"2236";"Ñiquén";"35-39";398;382;780
"2237";"Ñiquén";"40-44";445;376;821
"2238";"Ñiquén";"45-49";464;399;863
"2239";"Ñiquén";"50-54";471;420;891
"2240";"Ñiquén";"55-59";450;345;795
"2241";"Ñiquén";"60-64";318;315;633
"2242";"Ñiquén";"65-69";275;314;589
"2243";"Ñiquén";"70-74";244;229;473
"2244";"Ñiquén";"75-80";353;350;703
"2245";"Ñuñoa";"20-24";7851;8219;16070
"2246";"Ñuñoa";"25-29";8448;8894;17342
"2247";"Ñuñoa";"30-34";7431;7886;15317
"2248";"Ñuñoa";"35-39";6643;6865;13508
"2249";"Ñuñoa";"40-44";6587;7734;14321
"2250";"Ñuñoa";"45-49";6905;8841;15746
"2251";"Ñuñoa";"50-54";6682;8739;15421
"2252";"Ñuñoa";"55-59";5607;7764;13371
"2253";"Ñuñoa";"60-64";4558;6658;11216
"2254";"Ñuñoa";"65-69";4281;6533;10814
"2255";"Ñuñoa";"70-74";3706;5711;9417
"2256";"Ñuñoa";"75-80";5542;11676;17218
"2257";"O´Higgins";"20-24";39;37;76
"2258";"O´Higgins";"25-29";37;20;57
"2259";"O´Higgins";"30-34";29;26;55
"2260";"O´Higgins";"35-39";36;24;60
"2261";"O´Higgins";"40-44";35;16;51
"2262";"O´Higgins";"45-49";27;8;35
"2263";"O´Higgins";"50-54";24;15;39
"2264";"O´Higgins";"55-59";21;9;30
"2265";"O´Higgins";"60-64";18;9;27
"2266";"O´Higgins";"65-69";10;4;14
"2267";"O´Higgins";"70-74";5;2;7
"2268";"O´Higgins";"75-80";4;10;14
"2269";"Olivar";"20-24";696;733;1429
"2270";"Olivar";"25-29";595;536;1131
"2271";"Olivar";"30-34";528;456;984
"2272";"Olivar";"35-39";495;496;991
"2273";"Olivar";"40-44";487;544;1031
"2274";"Olivar";"45-49";595;493;1088
"2275";"Olivar";"50-54";487;422;909
"2276";"Olivar";"55-59";363;353;716
"2277";"Olivar";"60-64";302;251;553
"2278";"Olivar";"65-69";216;249;465
"2279";"Olivar";"70-74";155;174;329
"2280";"Olivar";"75-80";173;250;423
"2281";"Ollagüe";"20-24";15;9;24
"2282";"Ollagüe";"25-29";28;8;36
"2283";"Ollagüe";"30-34";23;14;37
"2284";"Ollagüe";"35-39";20;4;24
"2285";"Ollagüe";"40-44";16;4;20
"2286";"Ollagüe";"45-49";18;7;25
"2287";"Ollagüe";"50-54";15;1;16
"2288";"Ollagüe";"55-59";11;8;19
"2289";"Ollagüe";"60-64";6;5;11
"2290";"Ollagüe";"65-69";6;2;8
"2291";"Ollagüe";"70-74";3;2;5
"2292";"Ollagüe";"75-80";2;3;5
"2293";"Olmué";"20-24";615;647;1262
"2294";"Olmué";"25-29";602;590;1192
"2295";"Olmué";"30-34";546;501;1047
"2296";"Olmué";"35-39";518;495;1013
"2297";"Olmué";"40-44";512;491;1003
"2298";"Olmué";"45-49";511;514;1025
"2299";"Olmué";"50-54";512;524;1036
"2300";"Olmué";"55-59";462;465;927
"2301";"Olmué";"60-64";388;393;781
"2302";"Olmué";"65-69";347;303;650
"2303";"Olmué";"70-74";273;246;519
"2304";"Olmué";"75-80";379;455;834
"2305";"Osorno";"20-24";6705;7020;13725
"2306";"Osorno";"25-29";5625;5829;11454
"2307";"Osorno";"30-34";4709;4965;9674
"2308";"Osorno";"35-39";5195;5582;10777
"2309";"Osorno";"40-44";5932;6369;12301
"2310";"Osorno";"45-49";5861;6214;12075
"2311";"Osorno";"50-54";5095;5390;10485
"2312";"Osorno";"55-59";3883;4176;8059
"2313";"Osorno";"60-64";3042;3392;6434
"2314";"Osorno";"65-69";2400;2982;5382
"2315";"Osorno";"70-74";1881;2485;4366
"2316";"Osorno";"75-80";2266;3825;6091
"2317";"Ovalle";"20-24";4826;4825;9651
"2318";"Ovalle";"25-29";4384;4497;8881
"2319";"Ovalle";"30-34";3824;3943;7767
"2320";"Ovalle";"35-39";3892;4165;8057
"2321";"Ovalle";"40-44";3966;4087;8053
"2322";"Ovalle";"45-49";3925;4039;7964
"2323";"Ovalle";"50-54";3609;3650;7259
"2324";"Ovalle";"55-59";3007;3173;6180
"2325";"Ovalle";"60-64";2393;2556;4949
"2326";"Ovalle";"65-69";1893;2171;4064
"2327";"Ovalle";"70-74";1537;1772;3309
"2328";"Ovalle";"75-80";2148;3119;5267
"2329";"Padre Hurtado";"20-24";2149;2101;4250
"2330";"Padre Hurtado";"25-29";2378;2340;4718
"2331";"Padre Hurtado";"30-34";2118;2119;4237
"2332";"Padre Hurtado";"35-39";2073;1975;4048
"2333";"Padre Hurtado";"40-44";1832;1793;3625
"2334";"Padre Hurtado";"45-49";1848;1813;3661
"2335";"Padre Hurtado";"50-54";1755;1735;3490
"2336";"Padre Hurtado";"55-59";1449;1429;2878
"2337";"Padre Hurtado";"60-64";1203;1163;2366
"2338";"Padre Hurtado";"65-69";793;863;1656
"2339";"Padre Hurtado";"70-74";596;494;1090
"2340";"Padre Hurtado";"75-80";616;787;1403
"2341";"Padre Las Casas";"20-24";4040;3678;7718
"2342";"Padre Las Casas";"25-29";3585;3626;7211
"2343";"Padre Las Casas";"30-34";2880;3085;5965
"2344";"Padre Las Casas";"35-39";2938;2920;5858
"2345";"Padre Las Casas";"40-44";2816;2882;5698
"2346";"Padre Las Casas";"45-49";2713;2897;5610
"2347";"Padre Las Casas";"50-54";2557;2412;4969
"2348";"Padre Las Casas";"55-59";1848;1958;3806
"2349";"Padre Las Casas";"60-64";1405;1538;2943
"2350";"Padre Las Casas";"65-69";1167;1278;2445
"2351";"Padre Las Casas";"70-74";818;1024;1842
"2352";"Padre Las Casas";"75-80";1030;1599;2629
"2353";"Paiguano";"20-24";141;132;273
"2354";"Paiguano";"25-29";159;155;314
"2355";"Paiguano";"30-34";183;153;336
"2356";"Paiguano";"35-39";161;167;328
"2357";"Paiguano";"40-44";181;139;320
"2358";"Paiguano";"45-49";189;128;317
"2359";"Paiguano";"50-54";162;134;296
"2360";"Paiguano";"55-59";133;132;265
"2361";"Paiguano";"60-64";130;108;238
"2362";"Paiguano";"65-69";96;95;191
"2363";"Paiguano";"70-74";81;72;153
"2364";"Paiguano";"75-80";118;104;222
"2365";"Paillaco";"20-24";831;865;1696
"2366";"Paillaco";"25-29";790;836;1626
"2367";"Paillaco";"30-34";699;658;1357
"2368";"Paillaco";"35-39";663;614;1277
"2369";"Paillaco";"40-44";753;705;1458
"2370";"Paillaco";"45-49";780;774;1554
"2371";"Paillaco";"50-54";710;647;1357
"2372";"Paillaco";"55-59";583;571;1154
"2373";"Paillaco";"60-64";466;441;907
"2374";"Paillaco";"65-69";382;382;764
"2375";"Paillaco";"70-74";315;323;638
"2376";"Paillaco";"75-80";442;590;1032
"2377";"Paine";"20-24";2772;2598;5370
"2378";"Paine";"25-29";2650;2572;5222
"2379";"Paine";"30-34";2640;2538;5178
"2380";"Paine";"35-39";2549;2406;4955
"2381";"Paine";"40-44";2442;2150;4592
"2382";"Paine";"45-49";2174;2062;4236
"2383";"Paine";"50-54";2151;1964;4115
"2384";"Paine";"55-59";1757;1432;3189
"2385";"Paine";"60-64";1314;1173;2487
"2386";"Paine";"65-69";962;939;1901
"2387";"Paine";"70-74";688;629;1317
"2388";"Paine";"75-80";838;964;1802
"2389";"Palena";"20-24";64;62;126
"2390";"Palena";"25-29";50;70;120
"2391";"Palena";"30-34";84;64;148
"2392";"Palena";"35-39";114;86;200
"2393";"Palena";"40-44";95;51;146
"2394";"Palena";"45-49";127;86;213
"2395";"Palena";"50-54";106;56;162
"2396";"Palena";"55-59";74;85;159
"2397";"Palena";"60-64";51;32;83
"2398";"Palena";"65-69";49;36;85
"2399";"Palena";"70-74";25;28;53
"2400";"Palena";"75-80";40;48;88
"2401";"Palmilla";"20-24";622;504;1126
"2402";"Palmilla";"25-29";447;498;945
"2403";"Palmilla";"30-34";406;406;812
"2404";"Palmilla";"35-39";494;445;939
"2405";"Palmilla";"40-44";506;445;951
"2406";"Palmilla";"45-49";499;482;981
"2407";"Palmilla";"50-54";452;381;833
"2408";"Palmilla";"55-59";419;374;793
"2409";"Palmilla";"60-64";327;275;602
"2410";"Palmilla";"65-69";235;235;470
"2411";"Palmilla";"70-74";186;148;334
"2412";"Palmilla";"75-80";277;264;541
"2413";"Panguipulli";"20-24";1430;1300;2730
"2414";"Panguipulli";"25-29";1501;1486;2987
"2415";"Panguipulli";"30-34";1254;1194;2448
"2416";"Panguipulli";"35-39";1128;1063;2191
"2417";"Panguipulli";"40-44";1170;1134;2304
"2418";"Panguipulli";"45-49";1330;1228;2558
"2419";"Panguipulli";"50-54";1232;1106;2338
"2420";"Panguipulli";"55-59";1004;919;1923
"2421";"Panguipulli";"60-64";808;771;1579
"2422";"Panguipulli";"65-69";648;598;1246
"2423";"Panguipulli";"70-74";553;571;1124
"2424";"Panguipulli";"75-80";724;792;1516
"2425";"Panquehue";"20-24";310;318;628
"2426";"Panquehue";"25-29";321;320;641
"2427";"Panquehue";"30-34";276;260;536
"2428";"Panquehue";"35-39";238;241;479
"2429";"Panquehue";"40-44";234;241;475
"2430";"Panquehue";"45-49";250;235;485
"2431";"Panquehue";"50-54";249;229;478
"2432";"Panquehue";"55-59";191;180;371
"2433";"Panquehue";"60-64";149;138;287
"2434";"Panquehue";"65-69";117;101;218
"2435";"Panquehue";"70-74";86;93;179
"2436";"Panquehue";"75-80";141;143;284
"2437";"Papudo";"20-24";188;190;378
"2438";"Papudo";"25-29";181;189;370
"2439";"Papudo";"30-34";185;176;361
"2440";"Papudo";"35-39";215;173;388
"2441";"Papudo";"40-44";182;174;356
"2442";"Papudo";"45-49";183;175;358
"2443";"Papudo";"50-54";173;164;337
"2444";"Papudo";"55-59";147;140;287
"2445";"Papudo";"60-64";116;130;246
"2446";"Papudo";"65-69";94;112;206
"2447";"Papudo";"70-74";89;81;170
"2448";"Papudo";"75-80";102;88;190
"2449";"Paredones";"20-24";248;217;465
"2450";"Paredones";"25-29";217;186;403
"2451";"Paredones";"30-34";212;196;408
"2452";"Paredones";"35-39";236;187;423
"2453";"Paredones";"40-44";238;222;460
"2454";"Paredones";"45-49";247;200;447
"2455";"Paredones";"50-54";227;211;438
"2456";"Paredones";"55-59";209;205;414
"2457";"Paredones";"60-64";191;172;363
"2458";"Paredones";"65-69";195;146;341
"2459";"Paredones";"70-74";129;118;247
"2460";"Paredones";"75-80";199;228;427
"2461";"Parral";"20-24";1427;1373;2800
"2462";"Parral";"25-29";1299;1323;2622
"2463";"Parral";"30-34";1187;1281;2468
"2464";"Parral";"35-39";1328;1218;2546
"2465";"Parral";"40-44";1396;1334;2730
"2466";"Parral";"45-49";1476;1482;2958
"2467";"Parral";"50-54";1393;1223;2616
"2468";"Parral";"55-59";1226;1170;2396
"2469";"Parral";"60-64";950;1007;1957
"2470";"Parral";"65-69";804;784;1588
"2471";"Parral";"70-74";553;637;1190
"2472";"Parral";"75-80";788;985;1773
"2473";"Pedro Aguirre Cerda";"20-24";4827;4638;9465
"2474";"Pedro Aguirre Cerda";"25-29";4455;4259;8714
"2475";"Pedro Aguirre Cerda";"30-34";3987;3886;7873
"2476";"Pedro Aguirre Cerda";"35-39";4283;4205;8488
"2477";"Pedro Aguirre Cerda";"40-44";4605;4655;9260
"2478";"Pedro Aguirre Cerda";"45-49";4619;4613;9232
"2479";"Pedro Aguirre Cerda";"50-54";4080;4336;8416
"2480";"Pedro Aguirre Cerda";"55-59";3032;3386;6418
"2481";"Pedro Aguirre Cerda";"60-64";2483;2960;5443
"2482";"Pedro Aguirre Cerda";"65-69";2296;3245;5541
"2483";"Pedro Aguirre Cerda";"70-74";2066;2732;4798
"2484";"Pedro Aguirre Cerda";"75-80";2722;4380;7102
"2485";"Pelarco";"20-24";308;295;603
"2486";"Pelarco";"25-29";299;297;596
"2487";"Pelarco";"30-34";227;268;495
"2488";"Pelarco";"35-39";271;259;530
"2489";"Pelarco";"40-44";294;260;554
"2490";"Pelarco";"45-49";292;274;566
"2491";"Pelarco";"50-54";288;233;521
"2492";"Pelarco";"55-59";254;216;470
"2493";"Pelarco";"60-64";178;181;359
"2494";"Pelarco";"65-69";176;166;342
"2495";"Pelarco";"70-74";132;99;231
"2496";"Pelarco";"75-80";172;180;352
"2497";"Pelluhue";"20-24";316;261;577
"2498";"Pelluhue";"25-29";278;236;514
"2499";"Pelluhue";"30-34";270;224;494
"2500";"Pelluhue";"35-39";254;208;462
"2501";"Pelluhue";"40-44";274;220;494
"2502";"Pelluhue";"45-49";286;242;528
"2503";"Pelluhue";"50-54";264;234;498
"2504";"Pelluhue";"55-59";246;212;458
"2505";"Pelluhue";"60-64";246;207;453
"2506";"Pelluhue";"65-69";196;130;326
"2507";"Pelluhue";"70-74";133;128;261
"2508";"Pelluhue";"75-80";177;220;397
"2509";"Pemuco";"20-24";394;331;725
"2510";"Pemuco";"25-29";352;359;711
"2511";"Pemuco";"30-34";305;285;590
"2512";"Pemuco";"35-39";313;289;602
"2513";"Pemuco";"40-44";354;283;637
"2514";"Pemuco";"45-49";339;302;641
"2515";"Pemuco";"50-54";245;270;515
"2516";"Pemuco";"55-59";279;250;529
"2517";"Pemuco";"60-64";276;205;481
"2518";"Pemuco";"65-69";176;175;351
"2519";"Pemuco";"70-74";151;161;312
"2520";"Pemuco";"75-80";205;216;421
"2521";"Pencahue";"20-24";418;330;748
"2522";"Pencahue";"25-29";360;308;668
"2523";"Pencahue";"30-34";303;268;571
"2524";"Pencahue";"35-39";328;265;593
"2525";"Pencahue";"40-44";370;272;642
"2526";"Pencahue";"45-49";392;241;633
"2527";"Pencahue";"50-54";340;261;601
"2528";"Pencahue";"55-59";322;229;551
"2529";"Pencahue";"60-64";235;212;447
"2530";"Pencahue";"65-69";228;169;397
"2531";"Pencahue";"70-74";150;151;301
"2532";"Pencahue";"75-80";202;233;435
"2533";"Penco";"20-24";2344;2352;4696
"2534";"Penco";"25-29";2176;2209;4385
"2535";"Penco";"30-34";1707;1789;3496
"2536";"Penco";"35-39";1719;1788;3507
"2537";"Penco";"40-44";1865;1947;3812
"2538";"Penco";"45-49";1924;1994;3918
"2539";"Penco";"50-54";1761;1887;3648
"2540";"Penco";"55-59";1361;1592;2953
"2541";"Penco";"60-64";997;1136;2133
"2542";"Penco";"65-69";647;791;1438
"2543";"Penco";"70-74";431;700;1131
"2544";"Penco";"75-80";651;1066;1717
"2545";"Peñaflor";"20-24";3312;3393;6705
"2546";"Peñaflor";"25-29";3660;3789;7449
"2547";"Peñaflor";"30-34";3757;3531;7288
"2548";"Peñaflor";"35-39";3331;3360;6691
"2549";"Peñaflor";"40-44";3038;3053;6091
"2550";"Peñaflor";"45-49";2804;2971;5775
"2551";"Peñaflor";"50-54";2805;2909;5714
"2552";"Peñaflor";"55-59";2134;2379;4513
"2553";"Peñaflor";"60-64";1778;1813;3591
"2554";"Peñaflor";"65-69";1312;1346;2658
"2555";"Peñaflor";"70-74";812;970;1782
"2556";"Peñaflor";"75-80";981;1498;2479
"2557";"Peñalolen";"20-24";10110;9994;20104
"2558";"Peñalolen";"25-29";10334;10476;20810
"2559";"Peñalolen";"30-34";10002;10327;20329
"2560";"Peñalolen";"35-39";9091;9263;18354
"2561";"Peñalolen";"40-44";8323;8172;16495
"2562";"Peñalolen";"45-49";8085;8409;16494
"2563";"Peñalolen";"50-54";7956;8405;16361
"2564";"Peñalolen";"55-59";6224;6875;13099
"2565";"Peñalolen";"60-64";4587;5250;9837
"2566";"Peñalolen";"65-69";3190;3703;6893
"2567";"Peñalolen";"70-74";1864;2403;4267
"2568";"Peñalolen";"75-80";1944;3514;5458
"2569";"Peralillo";"20-24";481;356;837
"2570";"Peralillo";"25-29";387;392;779
"2571";"Peralillo";"30-34";366;327;693
"2572";"Peralillo";"35-39";384;376;760
"2573";"Peralillo";"40-44";434;350;784
"2574";"Peralillo";"45-49";416;403;819
"2575";"Peralillo";"50-54";430;443;873
"2576";"Peralillo";"55-59";353;312;665
"2577";"Peralillo";"60-64";304;263;567
"2578";"Peralillo";"65-69";264;220;484
"2579";"Peralillo";"70-74";196;171;367
"2580";"Peralillo";"75-80";283;286;569
"2581";"Perquenco";"20-24";296;273;569
"2582";"Perquenco";"25-29";270;269;539
"2583";"Perquenco";"30-34";228;232;460
"2584";"Perquenco";"35-39";255;227;482
"2585";"Perquenco";"40-44";253;251;504
"2586";"Perquenco";"45-49";246;230;476
"2587";"Perquenco";"50-54";230;203;433
"2588";"Perquenco";"55-59";209;188;397
"2589";"Perquenco";"60-64";167;168;335
"2590";"Perquenco";"65-69";162;148;310
"2591";"Perquenco";"70-74";119;123;242
"2592";"Perquenco";"75-80";151;170;321
"2593";"Petorca";"20-24";391;342;733
"2594";"Petorca";"25-29";407;392;799
"2595";"Petorca";"30-34";386;392;778
"2596";"Petorca";"35-39";364;306;670
"2597";"Petorca";"40-44";327;311;638
"2598";"Petorca";"45-49";343;329;672
"2599";"Petorca";"50-54";362;309;671
"2600";"Petorca";"55-59";288;257;545
"2601";"Petorca";"60-64";254;236;490
"2602";"Petorca";"65-69";179;218;397
"2603";"Petorca";"70-74";156;148;304
"2604";"Petorca";"75-80";211;309;520
"2605";"Peumo";"20-24";657;638;1295
"2606";"Peumo";"25-29";605;521;1126
"2607";"Peumo";"30-34";510;487;997
"2608";"Peumo";"35-39";561;582;1143
"2609";"Peumo";"40-44";615;532;1147
"2610";"Peumo";"45-49";584;607;1191
"2611";"Peumo";"50-54";569;555;1124
"2612";"Peumo";"55-59";481;443;924
"2613";"Peumo";"60-64";327;373;700
"2614";"Peumo";"65-69";285;262;547
"2615";"Peumo";"70-74";224;229;453
"2616";"Peumo";"75-80";320;341;661
"2617";"Pica";"20-24";306;112;418
"2618";"Pica";"25-29";641;148;789
"2619";"Pica";"30-34";736;148;884
"2620";"Pica";"35-39";666;103;769
"2621";"Pica";"40-44";537;125;662
"2622";"Pica";"45-49";384;116;500
"2623";"Pica";"50-54";289;140;429
"2624";"Pica";"55-59";209;104;313
"2625";"Pica";"60-64";104;109;213
"2626";"Pica";"65-69";82;98;180
"2627";"Pica";"70-74";76;71;147
"2628";"Pica";"75-80";90;117;207
"2629";"Pichidegua";"20-24";780;738;1518
"2630";"Pichidegua";"25-29";662;599;1261
"2631";"Pichidegua";"30-34";639;638;1277
"2632";"Pichidegua";"35-39";693;706;1399
"2633";"Pichidegua";"40-44";760;723;1483
"2634";"Pichidegua";"45-49";833;716;1549
"2635";"Pichidegua";"50-54";811;681;1492
"2636";"Pichidegua";"55-59";636;539;1175
"2637";"Pichidegua";"60-64";486;457;943
"2638";"Pichidegua";"65-69";422;348;770
"2639";"Pichidegua";"70-74";340;255;595
"2640";"Pichidegua";"75-80";477;467;944
"2641";"Pichilemu";"20-24";511;469;980
"2642";"Pichilemu";"25-29";512;454;966
"2643";"Pichilemu";"30-34";500;450;950
"2644";"Pichilemu";"35-39";538;525;1063
"2645";"Pichilemu";"40-44";591;495;1086
"2646";"Pichilemu";"45-49";607;493;1100
"2647";"Pichilemu";"50-54";496;447;943
"2648";"Pichilemu";"55-59";421;373;794
"2649";"Pichilemu";"60-64";350;366;716
"2650";"Pichilemu";"65-69";278;317;595
"2651";"Pichilemu";"70-74";237;208;445
"2652";"Pichilemu";"75-80";276;307;583
"2653";"Pinto";"20-24";396;388;784
"2654";"Pinto";"25-29";398;446;844
"2655";"Pinto";"30-34";395;375;770
"2656";"Pinto";"35-39";339;336;675
"2657";"Pinto";"40-44";387;389;776
"2658";"Pinto";"45-49";408;381;789
"2659";"Pinto";"50-54";392;361;753
"2660";"Pinto";"55-59";336;335;671
"2661";"Pinto";"60-64";320;275;595
"2662";"Pinto";"65-69";240;227;467
"2663";"Pinto";"70-74";189;197;386
"2664";"Pinto";"75-80";273;277;550
"2665";"Pirque";"20-24";725;793;1518
"2666";"Pirque";"25-29";761;804;1565
"2667";"Pirque";"30-34";783;830;1613
"2668";"Pirque";"35-39";854;914;1768
"2669";"Pirque";"40-44";882;780;1662
"2670";"Pirque";"45-49";784;695;1479
"2671";"Pirque";"50-54";692;638;1330
"2672";"Pirque";"55-59";613;463;1076
"2673";"Pirque";"60-64";433;390;823
"2674";"Pirque";"65-69";353;303;656
"2675";"Pirque";"70-74";252;192;444
"2676";"Pirque";"75-80";295;335;630
"2677";"Pitrufquén";"20-24";943;965;1908
"2678";"Pitrufquén";"25-29";903;950;1853
"2679";"Pitrufquén";"30-34";779;811;1590
"2680";"Pitrufquén";"35-39";801;807;1608
"2681";"Pitrufquén";"40-44";837;814;1651
"2682";"Pitrufquén";"45-49";903;798;1701
"2683";"Pitrufquén";"50-54";815;825;1640
"2684";"Pitrufquén";"55-59";736;719;1455
"2685";"Pitrufquén";"60-64";579;601;1180
"2686";"Pitrufquén";"65-69";484;550;1034
"2687";"Pitrufquén";"70-74";390;449;839
"2688";"Pitrufquén";"75-80";593;895;1488
"2689";"Placilla";"20-24";407;385;792
"2690";"Placilla";"25-29";333;314;647
"2691";"Placilla";"30-34";263;272;535
"2692";"Placilla";"35-39";350;328;678
"2693";"Placilla";"40-44";354;314;668
"2694";"Placilla";"45-49";324;308;632
"2695";"Placilla";"50-54";323;281;604
"2696";"Placilla";"55-59";242;239;481
"2697";"Placilla";"60-64";213;212;425
"2698";"Placilla";"65-69";184;176;360
"2699";"Placilla";"70-74";147;151;298
"2700";"Placilla";"75-80";191;209;400
"2701";"Portezuelo";"20-24";182;161;343
"2702";"Portezuelo";"25-29";150;162;312
"2703";"Portezuelo";"30-34";166;178;344
"2704";"Portezuelo";"35-39";193;180;373
"2705";"Portezuelo";"40-44";230;172;402
"2706";"Portezuelo";"45-49";215;172;387
"2707";"Portezuelo";"50-54";231;182;413
"2708";"Portezuelo";"55-59";180;183;363
"2709";"Portezuelo";"60-64";178;172;350
"2710";"Portezuelo";"65-69";151;132;283
"2711";"Portezuelo";"70-74";116;112;228
"2712";"Portezuelo";"75-80";131;157;288
"2713";"Porvenir";"20-24";273;177;450
"2714";"Porvenir";"25-29";288;158;446
"2715";"Porvenir";"30-34";294;211;505
"2716";"Porvenir";"35-39";322;208;530
"2717";"Porvenir";"40-44";300;206;506
"2718";"Porvenir";"45-49";295;222;517
"2719";"Porvenir";"50-54";330;216;546
"2720";"Porvenir";"55-59";273;185;458
"2721";"Porvenir";"60-64";255;128;383
"2722";"Porvenir";"65-69";149;100;249
"2723";"Porvenir";"70-74";113;82;195
"2724";"Porvenir";"75-80";89;158;247
"2725";"Pozo Almonte";"20-24";763;407;1170
"2726";"Pozo Almonte";"25-29";751;434;1185
"2727";"Pozo Almonte";"30-34";679;446;1125
"2728";"Pozo Almonte";"35-39";623;382;1005
"2729";"Pozo Almonte";"40-44";593;298;891
"2730";"Pozo Almonte";"45-49";529;319;848
"2731";"Pozo Almonte";"50-54";446;223;669
"2732";"Pozo Almonte";"55-59";405;275;680
"2733";"Pozo Almonte";"60-64";308;188;496
"2734";"Pozo Almonte";"65-69";197;163;360
"2735";"Pozo Almonte";"70-74";163;99;262
"2736";"Pozo Almonte";"75-80";191;150;341
"2737";"Primavera";"20-24";17;14;31
"2738";"Primavera";"25-29";28;19;47
"2739";"Primavera";"30-34";34;26;60
"2740";"Primavera";"35-39";34;29;63
"2741";"Primavera";"40-44";31;23;54
"2742";"Primavera";"45-49";33;16;49
"2743";"Primavera";"50-54";41;10;51
"2744";"Primavera";"55-59";35;17;52
"2745";"Primavera";"60-64";17;7;24
"2746";"Primavera";"65-69";10;5;15
"2747";"Primavera";"70-74";2;1;3
"2748";"Primavera";"75-80";2;4;6
"2749";"Providencia";"20-24";5932;6603;12535
"2750";"Providencia";"25-29";7458;7875;15333
"2751";"Providencia";"30-34";6057;5985;12042
"2752";"Providencia";"35-39";4213;4303;8516
"2753";"Providencia";"40-44";3792;4133;7925
"2754";"Providencia";"45-49";3986;5273;9259
"2755";"Providencia";"50-54";4282;5759;10041
"2756";"Providencia";"55-59";3825;5645;9470
"2757";"Providencia";"60-64";3122;4845;7967
"2758";"Providencia";"65-69";2833;4322;7155
"2759";"Providencia";"70-74";2268;3778;6046
"2760";"Providencia";"75-80";4572;10475;15047
"2761";"Puchuncaví";"20-24";657;636;1293
"2762";"Puchuncaví";"25-29";710;699;1409
"2763";"Puchuncaví";"30-34";680;569;1249
"2764";"Puchuncaví";"35-39";606;530;1136
"2765";"Puchuncaví";"40-44";628;535;1163
"2766";"Puchuncaví";"45-49";600;537;1137
"2767";"Puchuncaví";"50-54";583;598;1181
"2768";"Puchuncaví";"55-59";518;519;1037
"2769";"Puchuncaví";"60-64";442;399;841
"2770";"Puchuncaví";"65-69";387;385;772
"2771";"Puchuncaví";"70-74";240;247;487
"2772";"Puchuncaví";"75-80";339;405;744
"2773";"Pucón";"20-24";1283;1294;2577
"2774";"Pucón";"25-29";1268;1270;2538
"2775";"Pucón";"30-34";988;948;1936
"2776";"Pucón";"35-39";966;852;1818
"2777";"Pucón";"40-44";914;847;1761
"2778";"Pucón";"45-49";893;844;1737
"2779";"Pucón";"50-54";818;709;1527
"2780";"Pucón";"55-59";633;565;1198
"2781";"Pucón";"60-64";497;496;993
"2782";"Pucón";"65-69";383;415;798
"2783";"Pucón";"70-74";271;271;542
"2784";"Pucón";"75-80";444;565;1009
"2785";"Pudahuel";"20-24";9605;9365;18970
"2786";"Pudahuel";"25-29";9339;9274;18613
"2787";"Pudahuel";"30-34";9046;9387;18433
"2788";"Pudahuel";"35-39";9831;9873;19704
"2789";"Pudahuel";"40-44";8998;8967;17965
"2790";"Pudahuel";"45-49";8160;8172;16332
"2791";"Pudahuel";"50-54";6871;7034;13905
"2792";"Pudahuel";"55-59";5039;5496;10535
"2793";"Pudahuel";"60-64";3993;4371;8364
"2794";"Pudahuel";"65-69";2845;3313;6158
"2795";"Pudahuel";"70-74";1566;1981;3547
"2796";"Pudahuel";"75-80";1629;2760;4389
"2797";"Puente Alto";"20-24";23381;22886;46267
"2798";"Puente Alto";"25-29";22877;23918;46795
"2799";"Puente Alto";"30-34";24090;26264;50354
"2800";"Puente Alto";"35-39";26192;27385;53577
"2801";"Puente Alto";"40-44";25444;25614;51058
"2802";"Puente Alto";"45-49";22583;22303;44886
"2803";"Puente Alto";"50-54";17171;17143;34314
"2804";"Puente Alto";"55-59";11290;12093;23383
"2805";"Puente Alto";"60-64";7780;9288;17068
"2806";"Puente Alto";"65-69";5836;6931;12767
"2807";"Puente Alto";"70-74";3553;4967;8520
"2808";"Puente Alto";"75-80";3896;7312;11208
"2809";"Puerto Montt";"20-24";10960;10316;21276
"2810";"Puerto Montt";"25-29";9683;9353;19036
"2811";"Puerto Montt";"30-34";8675;8511;17186
"2812";"Puerto Montt";"35-39";9132;9036;18168
"2813";"Puerto Montt";"40-44";9084;9142;18226
"2814";"Puerto Montt";"45-49";9068;8448;17516
"2815";"Puerto Montt";"50-54";7627;7093;14720
"2816";"Puerto Montt";"55-59";5590;5315;10905
"2817";"Puerto Montt";"60-64";3841;4219;8060
"2818";"Puerto Montt";"65-69";2968;3378;6346
"2819";"Puerto Montt";"70-74";2107;2574;4681
"2820";"Puerto Montt";"75-80";2557;4109;6666
"2821";"Puerto Octay";"20-24";408;337;745
"2822";"Puerto Octay";"25-29";346;306;652
"2823";"Puerto Octay";"30-34";320;293;613
"2824";"Puerto Octay";"35-39";381;300;681
"2825";"Puerto Octay";"40-44";423;338;761
"2826";"Puerto Octay";"45-49";424;336;760
"2827";"Puerto Octay";"50-54";372;296;668
"2828";"Puerto Octay";"55-59";300;243;543
"2829";"Puerto Octay";"60-64";260;192;452
"2830";"Puerto Octay";"65-69";177;143;320
"2831";"Puerto Octay";"70-74";139;121;260
"2832";"Puerto Octay";"75-80";170;159;329
"2833";"Puerto Varas";"20-24";1494;1413;2907
"2834";"Puerto Varas";"25-29";1454;1492;2946
"2835";"Puerto Varas";"30-34";1352;1343;2695
"2836";"Puerto Varas";"35-39";1411;1469;2880
"2837";"Puerto Varas";"40-44";1649;1596;3245
"2838";"Puerto Varas";"45-49";1641;1503;3144
"2839";"Puerto Varas";"50-54";1395;1182;2577
"2840";"Puerto Varas";"55-59";1002;957;1959
"2841";"Puerto Varas";"60-64";773;736;1509
"2842";"Puerto Varas";"65-69";614;594;1208
"2843";"Puerto Varas";"70-74";414;494;908
"2844";"Puerto Varas";"75-80";520;812;1332
"2845";"Pumanque";"20-24";113;112;225
"2846";"Pumanque";"25-29";103;83;186
"2847";"Pumanque";"30-34";96;81;177
"2848";"Pumanque";"35-39";123;109;232
"2849";"Pumanque";"40-44";132;115;247
"2850";"Pumanque";"45-49";136;133;269
"2851";"Pumanque";"50-54";132;110;242
"2852";"Pumanque";"55-59";129;126;255
"2853";"Pumanque";"60-64";99;99;198
"2854";"Pumanque";"65-69";103;83;186
"2855";"Pumanque";"70-74";72;75;147
"2856";"Pumanque";"75-80";107;111;218
"2857";"Punitaqui";"20-24";438;409;847
"2858";"Punitaqui";"25-29";390;399;789
"2859";"Punitaqui";"30-34";317;316;633
"2860";"Punitaqui";"35-39";346;280;626
"2861";"Punitaqui";"40-44";340;311;651
"2862";"Punitaqui";"45-49";351;353;704
"2863";"Punitaqui";"50-54";388;364;752
"2864";"Punitaqui";"55-59";335;299;634
"2865";"Punitaqui";"60-64";270;232;502
"2866";"Punitaqui";"65-69";237;219;456
"2867";"Punitaqui";"70-74";149;180;329
"2868";"Punitaqui";"75-80";239;347;586
"2869";"Punta Arenas";"20-24";4935;4857;9792
"2870";"Punta Arenas";"25-29";5545;4544;10089
"2871";"Punta Arenas";"30-34";4861;4391;9252
"2872";"Punta Arenas";"35-39";4921;4809;9730
"2873";"Punta Arenas";"40-44";4821;4637;9458
"2874";"Punta Arenas";"45-49";4839;4847;9686
"2875";"Punta Arenas";"50-54";4892;4516;9408
"2876";"Punta Arenas";"55-59";4031;3695;7726
"2877";"Punta Arenas";"60-64";2762;2764;5526
"2878";"Punta Arenas";"65-69";2070;2202;4272
"2879";"Punta Arenas";"70-74";1498;1775;3273
"2880";"Punta Arenas";"75-80";1717;2986;4703
"2881";"Puqueldón";"20-24";178;149;327
"2882";"Puqueldón";"25-29";152;135;287
"2883";"Puqueldón";"30-34";136;111;247
"2884";"Puqueldón";"35-39";124;109;233
"2885";"Puqueldón";"40-44";130;152;282
"2886";"Puqueldón";"45-49";122;139;261
"2887";"Puqueldón";"50-54";157;149;306
"2888";"Puqueldón";"55-59";90;131;221
"2889";"Puqueldón";"60-64";91;102;193
"2890";"Puqueldón";"65-69";70;96;166
"2891";"Puqueldón";"70-74";68;101;169
"2892";"Puqueldón";"75-80";70;183;253
"2893";"Purén";"20-24";521;480;1001
"2894";"Purén";"25-29";430;475;905
"2895";"Purén";"30-34";383;412;795
"2896";"Purén";"35-39";394;389;783
"2897";"Purén";"40-44";455;475;930
"2898";"Purén";"45-49";492;471;963
"2899";"Purén";"50-54";437;376;813
"2900";"Purén";"55-59";327;320;647
"2901";"Purén";"60-64";317;280;597
"2902";"Purén";"65-69";296;238;534
"2903";"Purén";"70-74";200;205;405
"2904";"Purén";"75-80";305;363;668
"2905";"Purranque";"20-24";805;710;1515
"2906";"Purranque";"25-29";640;639;1279
"2907";"Purranque";"30-34";607;601;1208
"2908";"Purranque";"35-39";757;732;1489
"2909";"Purranque";"40-44";793;800;1593
"2910";"Purranque";"45-49";892;792;1684
"2911";"Purranque";"50-54";752;730;1482
"2912";"Purranque";"55-59";649;602;1251
"2913";"Purranque";"60-64";562;502;1064
"2914";"Purranque";"65-69";421;481;902
"2915";"Purranque";"70-74";333;348;681
"2916";"Purranque";"75-80";484;605;1089
"2917";"Putaendo";"20-24";552;578;1130
"2918";"Putaendo";"25-29";602;579;1181
"2919";"Putaendo";"30-34";618;547;1165
"2920";"Putaendo";"35-39";526;540;1066
"2921";"Putaendo";"40-44";562;452;1014
"2922";"Putaendo";"45-49";547;526;1073
"2923";"Putaendo";"50-54";581;512;1093
"2924";"Putaendo";"55-59";514;448;962
"2925";"Putaendo";"60-64";401;423;824
"2926";"Putaendo";"65-69";349;386;735
"2927";"Putaendo";"70-74";294;272;566
"2928";"Putaendo";"75-80";392;508;900
"2929";"Putre";"20-24";114;40;154
"2930";"Putre";"25-29";80;43;123
"2931";"Putre";"30-34";82;43;125
"2932";"Putre";"35-39";74;41;115
"2933";"Putre";"40-44";111;36;147
"2934";"Putre";"45-49";168;48;216
"2935";"Putre";"50-54";59;33;92
"2936";"Putre";"55-59";54;38;92
"2937";"Putre";"60-64";47;45;92
"2938";"Putre";"65-69";57;60;117
"2939";"Putre";"70-74";38;36;74
"2940";"Putre";"75-80";47;83;130
"2941";"Puyehue";"20-24";459;407;866
"2942";"Puyehue";"25-29";408;367;775
"2943";"Puyehue";"30-34";354;363;717
"2944";"Puyehue";"35-39";402;352;754
"2945";"Puyehue";"40-44";418;406;824
"2946";"Puyehue";"45-49";450;388;838
"2947";"Puyehue";"50-54";402;375;777
"2948";"Puyehue";"55-59";335;299;634
"2949";"Puyehue";"60-64";291;236;527
"2950";"Puyehue";"65-69";201;199;400
"2951";"Puyehue";"70-74";178;182;360
"2952";"Puyehue";"75-80";206;218;424
"2953";"Queilén";"20-24";230;211;441
"2954";"Queilén";"25-29";228;171;399
"2955";"Queilén";"30-34";178;165;343
"2956";"Queilén";"35-39";218;163;381
"2957";"Queilén";"40-44";223;192;415
"2958";"Queilén";"45-49";232;209;441
"2959";"Queilén";"50-54";176;158;334
"2960";"Queilén";"55-59";139;151;290
"2961";"Queilén";"60-64";114;99;213
"2962";"Queilén";"65-69";82;99;181
"2963";"Queilén";"70-74";80;101;181
"2964";"Queilén";"75-80";120;169;289
"2965";"Quellón";"20-24";1636;1484;3120
"2966";"Quellón";"25-29";1441;1159;2600
"2967";"Quellón";"30-34";1264;1070;2334
"2968";"Quellón";"35-39";1306;1056;2362
"2969";"Quellón";"40-44";1331;947;2278
"2970";"Quellón";"45-49";1089;808;1897
"2971";"Quellón";"50-54";827;664;1491
"2972";"Quellón";"55-59";654;510;1164
"2973";"Quellón";"60-64";470;426;896
"2974";"Quellón";"65-69";311;310;621
"2975";"Quellón";"70-74";220;234;454
"2976";"Quellón";"75-80";272;453;725
"2977";"Quemchi";"20-24";382;300;682
"2978";"Quemchi";"25-29";382;304;686
"2979";"Quemchi";"30-34";321;250;571
"2980";"Quemchi";"35-39";313;252;565
"2981";"Quemchi";"40-44";371;278;649
"2982";"Quemchi";"45-49";361;283;644
"2983";"Quemchi";"50-54";320;294;614
"2984";"Quemchi";"55-59";277;245;522
"2985";"Quemchi";"60-64";245;204;449
"2986";"Quemchi";"65-69";172;194;366
"2987";"Quemchi";"70-74";139;154;293
"2988";"Quemchi";"75-80";225;357;582
"2989";"Quilaco";"20-24";146;115;261
"2990";"Quilaco";"25-29";112;117;229
"2991";"Quilaco";"30-34";107;109;216
"2992";"Quilaco";"35-39";127;109;236
"2993";"Quilaco";"40-44";141;122;263
"2994";"Quilaco";"45-49";163;148;311
"2995";"Quilaco";"50-54";179;147;326
"2996";"Quilaco";"55-59";153;143;296
"2997";"Quilaco";"60-64";148;120;268
"2998";"Quilaco";"65-69";106;100;206
"2999";"Quilaco";"70-74";89;63;152
"3000";"Quilaco";"75-80";122;145;267
"3001";"Quilicura";"20-24";7293;7768;15061
"3002";"Quilicura";"25-29";8603;9530;18133
"3003";"Quilicura";"30-34";10014;10336;20350
"3004";"Quilicura";"35-39";9109;8895;18004
"3005";"Quilicura";"40-44";7932;7644;15576
"3006";"Quilicura";"45-49";6703;6446;13149
"3007";"Quilicura";"50-54";4910;4992;9902
"3008";"Quilicura";"55-59";3232;3257;6489
"3009";"Quilicura";"60-64";2045;2213;4258
"3010";"Quilicura";"65-69";1322;1543;2865
"3011";"Quilicura";"70-74";819;959;1778
"3012";"Quilicura";"75-80";835;1404;2239
"3013";"Quilleco";"20-24";370;337;707
"3014";"Quilleco";"25-29";393;380;773
"3015";"Quilleco";"30-34";304;312;616
"3016";"Quilleco";"35-39";284;279;563
"3017";"Quilleco";"40-44";319;284;603
"3018";"Quilleco";"45-49";320;345;665
"3019";"Quilleco";"50-54";363;347;710
"3020";"Quilleco";"55-59";373;339;712
"3021";"Quilleco";"60-64";327;278;605
"3022";"Quilleco";"65-69";250;203;453
"3023";"Quilleco";"70-74";208;175;383
"3024";"Quilleco";"75-80";278;288;566
"3025";"Quillón";"20-24";589;528;1117
"3026";"Quillón";"25-29";545;592;1137
"3027";"Quillón";"30-34";533;532;1065
"3028";"Quillón";"35-39";525;491;1016
"3029";"Quillón";"40-44";590;570;1160
"3030";"Quillón";"45-49";636;595;1231
"3031";"Quillón";"50-54";633;580;1213
"3032";"Quillón";"55-59";578;523;1101
"3033";"Quillón";"60-64";522;463;985
"3034";"Quillón";"65-69";394;448;842
"3035";"Quillón";"70-74";313;344;657
"3036";"Quillón";"75-80";416;489;905
"3037";"Quillota";"20-24";3831;3633;7464
"3038";"Quillota";"25-29";3627;3658;7285
"3039";"Quillota";"30-34";3140;3102;6242
"3040";"Quillota";"35-39";2812;2988;5800
"3041";"Quillota";"40-44";2961;3134;6095
"3042";"Quillota";"45-49";3142;3443;6585
"3043";"Quillota";"50-54";3000;3298;6298
"3044";"Quillota";"55-59";2534;2659;5193
"3045";"Quillota";"60-64";1965;2108;4073
"3046";"Quillota";"65-69";1476;1804;3280
"3047";"Quillota";"70-74";1193;1502;2695
"3048";"Quillota";"75-80";1759;2815;4574
"3049";"Quilpué";"20-24";6525;6398;12923
"3050";"Quilpué";"25-29";6682;6608;13290
"3051";"Quilpué";"30-34";5997;5689;11686
"3052";"Quilpué";"35-39";4982;5317;10299
"3053";"Quilpué";"40-44";5161;5534;10695
"3054";"Quilpué";"45-49";5678;6062;11740
"3055";"Quilpué";"50-54";5479;6016;11495
"3056";"Quilpué";"55-59";4502;5330;9832
"3057";"Quilpué";"60-64";3631;4142;7773
"3058";"Quilpué";"65-69";2878;3634;6512
"3059";"Quilpué";"70-74";2115;2904;5019
"3060";"Quilpué";"75-80";3004;5565;8569
"3061";"Quinchao";"20-24";358;318;676
"3062";"Quinchao";"25-29";348;307;655
"3063";"Quinchao";"30-34";287;244;531
"3064";"Quinchao";"35-39";284;239;523
"3065";"Quinchao";"40-44";288;302;590
"3066";"Quinchao";"45-49";289;331;620
"3067";"Quinchao";"50-54";307;309;616
"3068";"Quinchao";"55-59";234;267;501
"3069";"Quinchao";"60-64";171;220;391
"3070";"Quinchao";"65-69";144;171;315
"3071";"Quinchao";"70-74";99;143;242
"3072";"Quinchao";"75-80";184;391;575
"3073";"Quinta de  Tilcoco";"20-24";542;520;1062
"3074";"Quinta de  Tilcoco";"25-29";442;366;808
"3075";"Quinta de  Tilcoco";"30-34";399;400;799
"3076";"Quinta de  Tilcoco";"35-39";472;506;978
"3077";"Quinta de  Tilcoco";"40-44";485;473;958
"3078";"Quinta de  Tilcoco";"45-49";489;450;939
"3079";"Quinta de  Tilcoco";"50-54";506;435;941
"3080";"Quinta de  Tilcoco";"55-59";396;362;758
"3081";"Quinta de  Tilcoco";"60-64";340;263;603
"3082";"Quinta de  Tilcoco";"65-69";252;216;468
"3083";"Quinta de  Tilcoco";"70-74";137;167;304
"3084";"Quinta de  Tilcoco";"75-80";246;312;558
"3085";"Quinta Normal";"20-24";4415;4322;8737
"3086";"Quinta Normal";"25-29";4887;4601;9488
"3087";"Quinta Normal";"30-34";4187;3863;8050
"3088";"Quinta Normal";"35-39";3891;3811;7702
"3089";"Quinta Normal";"40-44";3698;3789;7487
"3090";"Quinta Normal";"45-49";3813;4005;7818
"3091";"Quinta Normal";"50-54";4038;4219;8257
"3092";"Quinta Normal";"55-59";3402;3618;7020
"3093";"Quinta Normal";"60-64";2898;3305;6203
"3094";"Quinta Normal";"65-69";2414;2670;5084
"3095";"Quinta Normal";"70-74";1758;2313;4071
"3096";"Quinta Normal";"75-80";2206;4118;6324
"3097";"Quintero";"20-24";976;1060;2036
"3098";"Quintero";"25-29";1173;1012;2185
"3099";"Quintero";"30-34";964;932;1896
"3100";"Quintero";"35-39";822;855;1677
"3101";"Quintero";"40-44";780;838;1618
"3102";"Quintero";"45-49";830;893;1723
"3103";"Quintero";"50-54";847;931;1778
"3104";"Quintero";"55-59";725;853;1578
"3105";"Quintero";"60-64";692;722;1414
"3106";"Quintero";"65-69";547;591;1138
"3107";"Quintero";"70-74";431;447;878
"3108";"Quintero";"75-80";519;717;1236
"3109";"Quirihue";"20-24";506;471;977
"3110";"Quirihue";"25-29";504;478;982
"3111";"Quirihue";"30-34";428;393;821
"3112";"Quirihue";"35-39";412;362;774
"3113";"Quirihue";"40-44";457;462;919
"3114";"Quirihue";"45-49";520;431;951
"3115";"Quirihue";"50-54";493;431;924
"3116";"Quirihue";"55-59";428;373;801
"3117";"Quirihue";"60-64";378;363;741
"3118";"Quirihue";"65-69";269;287;556
"3119";"Quirihue";"70-74";215;242;457
"3120";"Quirihue";"75-80";342;408;750
"3121";"Rancagua";"20-24";9903;9715;19618
"3122";"Rancagua";"25-29";8587;8343;16930
"3123";"Rancagua";"30-34";7485;7309;14794
"3124";"Rancagua";"35-39";8009;8088;16097
"3125";"Rancagua";"40-44";8300;8949;17249
"3126";"Rancagua";"45-49";9070;9661;18731
"3127";"Rancagua";"50-54";8248;8855;17103
"3128";"Rancagua";"55-59";6592;6993;13585
"3129";"Rancagua";"60-64";4800;5320;10120
"3130";"Rancagua";"65-69";3307;4031;7338
"3131";"Rancagua";"70-74";2315;3239;5554
"3132";"Rancagua";"75-80";2823;4760;7583
"3133";"Ránquil";"20-24";186;197;383
"3134";"Ránquil";"25-29";184;172;356
"3135";"Ránquil";"30-34";168;164;332
"3136";"Ránquil";"35-39";184;178;362
"3137";"Ránquil";"40-44";224;225;449
"3138";"Ránquil";"45-49";230;239;469
"3139";"Ránquil";"50-54";264;225;489
"3140";"Ránquil";"55-59";205;199;404
"3141";"Ránquil";"60-64";203;196;399
"3142";"Ránquil";"65-69";139;155;294
"3143";"Ránquil";"70-74";116;130;246
"3144";"Ránquil";"75-80";172;217;389
"3145";"Rauco";"20-24";397;394;791
"3146";"Rauco";"25-29";359;397;756
"3147";"Rauco";"30-34";309;313;622
"3148";"Rauco";"35-39";361;296;657
"3149";"Rauco";"40-44";312;325;637
"3150";"Rauco";"45-49";402;352;754
"3151";"Rauco";"50-54";377;338;715
"3152";"Rauco";"55-59";301;313;614
"3153";"Rauco";"60-64";231;253;484
"3154";"Rauco";"65-69";204;199;403
"3155";"Rauco";"70-74";147;153;300
"3156";"Rauco";"75-80";212;246;458
"3157";"Recoleta";"20-24";7101;6721;13822
"3158";"Recoleta";"25-29";7361;6738;14099
"3159";"Recoleta";"30-34";6212;5728;11940
"3160";"Recoleta";"35-39";5544;5361;10905
"3161";"Recoleta";"40-44";5206;5239;10445
"3162";"Recoleta";"45-49";5718;5838;11556
"3163";"Recoleta";"50-54";5862;6383;12245
"3164";"Recoleta";"55-59";4969;5407;10376
"3165";"Recoleta";"60-64";3997;4563;8560
"3166";"Recoleta";"65-69";3031;3741;6772
"3167";"Recoleta";"70-74";2144;2950;5094
"3168";"Recoleta";"75-80";2717;5222;7939
"3169";"Renaico";"20-24";385;405;790
"3170";"Renaico";"25-29";371;419;790
"3171";"Renaico";"30-34";322;340;662
"3172";"Renaico";"35-39";328;305;633
"3173";"Renaico";"40-44";364;383;747
"3174";"Renaico";"45-49";386;382;768
"3175";"Renaico";"50-54";362;336;698
"3176";"Renaico";"55-59";270;305;575
"3177";"Renaico";"60-64";251;220;471
"3178";"Renaico";"65-69";188;162;350
"3179";"Renaico";"70-74";148;167;315
"3180";"Renaico";"75-80";228;293;521
"3181";"Renca";"20-24";7080;6596;13676
"3182";"Renca";"25-29";7017;6499;13516
"3183";"Renca";"30-34";5815;5366;11181
"3184";"Renca";"35-39";5049;4838;9887
"3185";"Renca";"40-44";4901;4957;9858
"3186";"Renca";"45-49";5277;5469;10746
"3187";"Renca";"50-54";5141;5507;10648
"3188";"Renca";"55-59";4245;4323;8568
"3189";"Renca";"60-64";2925;3296;6221
"3190";"Renca";"65-69";2138;2297;4435
"3191";"Renca";"70-74";1336;1683;3019
"3192";"Renca";"75-80";1447;2563;4010
"3193";"Rengo";"20-24";2547;2506;5053
"3194";"Rengo";"25-29";2112;2015;4127
"3195";"Rengo";"30-34";1993;1919;3912
"3196";"Rengo";"35-39";2073;2135;4208
"3197";"Rengo";"40-44";2122;2179;4301
"3198";"Rengo";"45-49";2255;2143;4398
"3199";"Rengo";"50-54";2026;2044;4070
"3200";"Rengo";"55-59";1635;1651;3286
"3201";"Rengo";"60-64";1211;1356;2567
"3202";"Rengo";"65-69";957;986;1943
"3203";"Rengo";"70-74";727;769;1496
"3204";"Rengo";"75-80";878;1344;2222
"3205";"Requínoa";"20-24";1309;1226;2535
"3206";"Requínoa";"25-29";1158;1095;2253
"3207";"Requínoa";"30-34";1058;957;2015
"3208";"Requínoa";"35-39";1069;1063;2132
"3209";"Requínoa";"40-44";1168;967;2135
"3210";"Requínoa";"45-49";1071;1015;2086
"3211";"Requínoa";"50-54";971;905;1876
"3212";"Requínoa";"55-59";772;683;1455
"3213";"Requínoa";"60-64";632;522;1154
"3214";"Requínoa";"65-69";469;460;929
"3215";"Requínoa";"70-74";314;284;598
"3216";"Requínoa";"75-80";405;446;851
"3217";"Retiro";"20-24";739;731;1470
"3218";"Retiro";"25-29";653;688;1341
"3219";"Retiro";"30-34";623;620;1243
"3220";"Retiro";"35-39";705;665;1370
"3221";"Retiro";"40-44";755;673;1428
"3222";"Retiro";"45-49";742;687;1429
"3223";"Retiro";"50-54";727;627;1354
"3224";"Retiro";"55-59";611;524;1135
"3225";"Retiro";"60-64";503;435;938
"3226";"Retiro";"65-69";390;385;775
"3227";"Retiro";"70-74";333;272;605
"3228";"Retiro";"75-80";384;432;816
"3229";"Rinconada";"20-24";437;397;834
"3230";"Rinconada";"25-29";362;389;751
"3231";"Rinconada";"30-34";428;431;859
"3232";"Rinconada";"35-39";380;308;688
"3233";"Rinconada";"40-44";312;262;574
"3234";"Rinconada";"45-49";310;307;617
"3235";"Rinconada";"50-54";314;331;645
"3236";"Rinconada";"55-59";275;253;528
"3237";"Rinconada";"60-64";230;215;445
"3238";"Rinconada";"65-69";194;180;374
"3239";"Rinconada";"70-74";145;127;272
"3240";"Rinconada";"75-80";188;192;380
"3241";"Río Bueno";"20-24";1185;1196;2381
"3242";"Río Bueno";"25-29";1300;1324;2624
"3243";"Río Bueno";"30-34";1102;1057;2159
"3244";"Río Bueno";"35-39";1067;991;2058
"3245";"Río Bueno";"40-44";1205;1126;2331
"3246";"Río Bueno";"45-49";1381;1244;2625
"3247";"Río Bueno";"50-54";1220;1151;2371
"3248";"Río Bueno";"55-59";1057;932;1989
"3249";"Río Bueno";"60-64";868;832;1700
"3250";"Río Bueno";"65-69";691;642;1333
"3251";"Río Bueno";"70-74";401;523;924
"3252";"Río Bueno";"75-80";670;924;1594
"3253";"Río Claro";"20-24";634;539;1173
"3254";"Río Claro";"25-29";528;512;1040
"3255";"Río Claro";"30-34";411;453;864
"3256";"Río Claro";"35-39";514;438;952
"3257";"Río Claro";"40-44";501;423;924
"3258";"Río Claro";"45-49";555;442;997
"3259";"Río Claro";"50-54";515;429;944
"3260";"Río Claro";"55-59";401;358;759
"3261";"Río Claro";"60-64";352;310;662
"3262";"Río Claro";"65-69";268;219;487
"3263";"Río Claro";"70-74";193;162;355
"3264";"Río Claro";"75-80";267;245;512
"3265";"Río Hurtado";"20-24";194;170;364
"3266";"Río Hurtado";"25-29";156;170;326
"3267";"Río Hurtado";"30-34";139;120;259
"3268";"Río Hurtado";"35-39";138;131;269
"3269";"Río Hurtado";"40-44";194;153;347
"3270";"Río Hurtado";"45-49";186;151;337
"3271";"Río Hurtado";"50-54";142;175;317
"3272";"Río Hurtado";"55-59";146;155;301
"3273";"Río Hurtado";"60-64";137;118;255
"3274";"Río Hurtado";"65-69";117;115;232
"3275";"Río Hurtado";"70-74";107;100;207
"3276";"Río Hurtado";"75-80";208;188;396
"3277";"Río Ibáñez";"20-24";60;65;125
"3278";"Río Ibáñez";"25-29";90;65;155
"3279";"Río Ibáñez";"30-34";68;65;133
"3280";"Río Ibáñez";"35-39";105;76;181
"3281";"Río Ibáñez";"40-44";100;69;169
"3282";"Río Ibáñez";"45-49";123;89;212
"3283";"Río Ibáñez";"50-54";106;109;215
"3284";"Río Ibáñez";"55-59";85;69;154
"3285";"Río Ibáñez";"60-64";71;51;122
"3286";"Río Ibáñez";"65-69";71;54;125
"3287";"Río Ibáñez";"70-74";52;42;94
"3288";"Río Ibáñez";"75-80";59;68;127
"3289";"Río Negro";"20-24";490;457;947
"3290";"Río Negro";"25-29";440;391;831
"3291";"Río Negro";"30-34";397;380;777
"3292";"Río Negro";"35-39";464;433;897
"3293";"Río Negro";"40-44";532;508;1040
"3294";"Río Negro";"45-49";638;537;1175
"3295";"Río Negro";"50-54";525;479;1004
"3296";"Río Negro";"55-59";520;406;926
"3297";"Río Negro";"60-64";365;312;677
"3298";"Río Negro";"65-69";302;289;591
"3299";"Río Negro";"70-74";233;239;472
"3300";"Río Negro";"75-80";307;354;661
"3301";"Río Verde";"20-24";9;4;13
"3302";"Río Verde";"25-29";18;4;22
"3303";"Río Verde";"30-34";10;1;11
"3304";"Río Verde";"35-39";11;3;14
"3305";"Río Verde";"40-44";9;1;10
"3306";"Río Verde";"45-49";12;5;17
"3307";"Río Verde";"50-54";8;2;10
"3308";"Río Verde";"55-59";15;3;18
"3309";"Río Verde";"60-64";8;2;10
"3310";"Río Verde";"65-69";5;0;5
"3311";"Río Verde";"70-74";1;1;2
"3312";"Río Verde";"75-80";2;2;4
"3313";"Romeral";"20-24";633;681;1314
"3314";"Romeral";"25-29";686;656;1342
"3315";"Romeral";"30-34";521;477;998
"3316";"Romeral";"35-39";542;514;1056
"3317";"Romeral";"40-44";528;508;1036
"3318";"Romeral";"45-49";564;508;1072
"3319";"Romeral";"50-54";552;485;1037
"3320";"Romeral";"55-59";430;374;804
"3321";"Romeral";"60-64";368;283;651
"3322";"Romeral";"65-69";270;240;510
"3323";"Romeral";"70-74";197;161;358
"3324";"Romeral";"75-80";216;208;424
"3325";"Saavedra";"20-24";521;480;1001
"3326";"Saavedra";"25-29";432;435;867
"3327";"Saavedra";"30-34";384;363;747
"3328";"Saavedra";"35-39";387;339;726
"3329";"Saavedra";"40-44";508;420;928
"3330";"Saavedra";"45-49";476;413;889
"3331";"Saavedra";"50-54";435;402;837
"3332";"Saavedra";"55-59";390;325;715
"3333";"Saavedra";"60-64";365;315;680
"3334";"Saavedra";"65-69";281;244;525
"3335";"Saavedra";"70-74";236;239;475
"3336";"Saavedra";"75-80";342;455;797
"3337";"Sagrada Familia";"20-24";912;839;1751
"3338";"Sagrada Familia";"25-29";727;750;1477
"3339";"Sagrada Familia";"30-34";683;627;1310
"3340";"Sagrada Familia";"35-39";705;626;1331
"3341";"Sagrada Familia";"40-44";754;685;1439
"3342";"Sagrada Familia";"45-49";799;705;1504
"3343";"Sagrada Familia";"50-54";714;582;1296
"3344";"Sagrada Familia";"55-59";587;492;1079
"3345";"Sagrada Familia";"60-64";504;430;934
"3346";"Sagrada Familia";"65-69";367;296;663
"3347";"Sagrada Familia";"70-74";289;263;552
"3348";"Sagrada Familia";"75-80";319;372;691
"3349";"Salamanca";"20-24";1081;899;1980
"3350";"Salamanca";"25-29";1196;1000;2196
"3351";"Salamanca";"30-34";1205;878;2083
"3352";"Salamanca";"35-39";1118;806;1924
"3353";"Salamanca";"40-44";1194;812;2006
"3354";"Salamanca";"45-49";1120;851;1971
"3355";"Salamanca";"50-54";1018;835;1853
"3356";"Salamanca";"55-59";841;745;1586
"3357";"Salamanca";"60-64";594;612;1206
"3358";"Salamanca";"65-69";501;514;1015
"3359";"Salamanca";"70-74";373;385;758
"3360";"Salamanca";"75-80";541;668;1209
"3361";"San Antonio";"20-24";3706;3808;7514
"3362";"San Antonio";"25-29";4177;3914;8091
"3363";"San Antonio";"30-34";3742;3507;7249
"3364";"San Antonio";"35-39";3149;3225;6374
"3365";"San Antonio";"40-44";3260;3253;6513
"3366";"San Antonio";"45-49";3281;3530;6811
"3367";"San Antonio";"50-54";3155;3512;6667
"3368";"San Antonio";"55-59";2503;2686;5189
"3369";"San Antonio";"60-64";2010;2241;4251
"3370";"San Antonio";"65-69";1499;1813;3312
"3371";"San Antonio";"70-74";1156;1397;2553
"3372";"San Antonio";"75-80";1502;2382;3884
"3373";"San Bernardo";"20-24";12276;11900;24176
"3374";"San Bernardo";"25-29";12029;12110;24139
"3375";"San Bernardo";"30-34";11919;11901;23820
"3376";"San Bernardo";"35-39";10674;10814;21488
"3377";"San Bernardo";"40-44";10569;10540;21109
"3378";"San Bernardo";"45-49";10032;10273;20305
"3379";"San Bernardo";"50-54";8991;9350;18341
"3380";"San Bernardo";"55-59";6921;7152;14073
"3381";"San Bernardo";"60-64";4922;5581;10503
"3382";"San Bernardo";"65-69";3724;4224;7948
"3383";"San Bernardo";"70-74";2464;3066;5530
"3384";"San Bernardo";"75-80";2878;4702;7580
"3385";"San Carlos";"20-24";1940;1877;3817
"3386";"San Carlos";"25-29";1795;1952;3747
"3387";"San Carlos";"30-34";1719;1782;3501
"3388";"San Carlos";"35-39";1567;1751;3318
"3389";"San Carlos";"40-44";1892;1945;3837
"3390";"San Carlos";"45-49";1858;1813;3671
"3391";"San Carlos";"50-54";1906;1860;3766
"3392";"San Carlos";"55-59";1558;1535;3093
"3393";"San Carlos";"60-64";1302;1326;2628
"3394";"San Carlos";"65-69";1016;1022;2038
"3395";"San Carlos";"70-74";809;810;1619
"3396";"San Carlos";"75-80";1106;1580;2686
"3397";"San Clemente";"20-24";1631;1751;3382
"3398";"San Clemente";"25-29";1572;1635;3207
"3399";"San Clemente";"30-34";1286;1433;2719
"3400";"San Clemente";"35-39";1357;1375;2732
"3401";"San Clemente";"40-44";1390;1386;2776
"3402";"San Clemente";"45-49";1506;1434;2940
"3403";"San Clemente";"50-54";1465;1416;2881
"3404";"San Clemente";"55-59";1249;1104;2353
"3405";"San Clemente";"60-64";1038;869;1907
"3406";"San Clemente";"65-69";768;710;1478
"3407";"San Clemente";"70-74";608;537;1145
"3408";"San Clemente";"75-80";806;788;1594
"3409";"San Esteban";"20-24";663;718;1381
"3410";"San Esteban";"25-29";781;797;1578
"3411";"San Esteban";"30-34";701;684;1385
"3412";"San Esteban";"35-39";651;640;1291
"3413";"San Esteban";"40-44";597;611;1208
"3414";"San Esteban";"45-49";656;579;1235
"3415";"San Esteban";"50-54";644;608;1252
"3416";"San Esteban";"55-59";515;494;1009
"3417";"San Esteban";"60-64";403;364;767
"3418";"San Esteban";"65-69";324;298;622
"3419";"San Esteban";"70-74";230;215;445
"3420";"San Esteban";"75-80";290;390;680
"3421";"San Fabián";"20-24";153;133;286
"3422";"San Fabián";"25-29";133;112;245
"3423";"San Fabián";"30-34";121;123;244
"3424";"San Fabián";"35-39";119;104;223
"3425";"San Fabián";"40-44";123;116;239
"3426";"San Fabián";"45-49";130;131;261
"3427";"San Fabián";"50-54";151;141;292
"3428";"San Fabián";"55-59";138;124;262
"3429";"San Fabián";"60-64";129;117;246
"3430";"San Fabián";"65-69";95;100;195
"3431";"San Fabián";"70-74";70;73;143
"3432";"San Fabián";"75-80";94;99;193
"3433";"San Felipe";"20-24";2750;2795;5545
"3434";"San Felipe";"25-29";3056;3042;6098
"3435";"San Felipe";"30-34";2699;2656;5355
"3436";"San Felipe";"35-39";2501;2618;5119
"3437";"San Felipe";"40-44";2447;2426;4873
"3438";"San Felipe";"45-49";2427;2586;5013
"3439";"San Felipe";"50-54";2385;2574;4959
"3440";"San Felipe";"55-59";1904;1991;3895
"3441";"San Felipe";"60-64";1405;1561;2966
"3442";"San Felipe";"65-69";1099;1297;2396
"3443";"San Felipe";"70-74";808;1136;1944
"3444";"San Felipe";"75-80";1231;2039;3270
"3445";"San Fernando";"20-24";2917;2920;5837
"3446";"San Fernando";"25-29";2474;2504;4978
"3447";"San Fernando";"30-34";2238;2272;4510
"3448";"San Fernando";"35-39";2474;2613;5087
"3449";"San Fernando";"40-44";2523;2740;5263
"3450";"San Fernando";"45-49";2572;2804;5376
"3451";"San Fernando";"50-54";2392;2460;4852
"3452";"San Fernando";"55-59";2005;2078;4083
"3453";"San Fernando";"60-64";1512;1692;3204
"3454";"San Fernando";"65-69";1066;1310;2376
"3455";"San Fernando";"70-74";895;1105;2000
"3456";"San Fernando";"75-80";1157;1796;2953
"3457";"San Gregorio";"20-24";15;9;24
"3458";"San Gregorio";"25-29";20;8;28
"3459";"San Gregorio";"30-34";22;15;37
"3460";"San Gregorio";"35-39";27;12;39
"3461";"San Gregorio";"40-44";27;11;38
"3462";"San Gregorio";"45-49";32;7;39
"3463";"San Gregorio";"50-54";37;9;46
"3464";"San Gregorio";"55-59";23;8;31
"3465";"San Gregorio";"60-64";11;12;23
"3466";"San Gregorio";"65-69";7;3;10
"3467";"San Gregorio";"70-74";3;5;8
"3468";"San Gregorio";"75-80";4;3;7
"3469";"San Ignacio";"20-24";593;555;1148
"3470";"San Ignacio";"25-29";558;560;1118
"3471";"San Ignacio";"30-34";495;536;1031
"3472";"San Ignacio";"35-39";512;506;1018
"3473";"San Ignacio";"40-44";577;542;1119
"3474";"San Ignacio";"45-49";620;561;1181
"3475";"San Ignacio";"50-54";538;479;1017
"3476";"San Ignacio";"55-59";513;438;951
"3477";"San Ignacio";"60-64";403;366;769
"3478";"San Ignacio";"65-69";338;330;668
"3479";"San Ignacio";"70-74";258;310;568
"3480";"San Ignacio";"75-80";389;473;862
"3481";"San Javier";"20-24";1665;1548;3213
"3482";"San Javier";"25-29";1404;1437;2841
"3483";"San Javier";"30-34";1296;1341;2637
"3484";"San Javier";"35-39";1363;1331;2694
"3485";"San Javier";"40-44";1380;1422;2802
"3486";"San Javier";"45-49";1499;1505;3004
"3487";"San Javier";"50-54";1478;1412;2890
"3488";"San Javier";"55-59";1221;1242;2463
"3489";"San Javier";"60-64";1054;1009;2063
"3490";"San Javier";"65-69";785;874;1659
"3491";"San Javier";"70-74";627;638;1265
"3492";"San Javier";"75-80";809;1118;1927
"3493";"San Joaquín";"20-24";4154;3959;8113
"3494";"San Joaquín";"25-29";4101;4056;8157
"3495";"San Joaquín";"30-34";3757;3804;7561
"3496";"San Joaquín";"35-39";3491;3487;6978
"3497";"San Joaquín";"40-44";3292;3495;6787
"3498";"San Joaquín";"45-49";3299;3721;7020
"3499";"San Joaquín";"50-54";3571;3879;7450
"3500";"San Joaquín";"55-59";3281;3689;6970
"3501";"San Joaquín";"60-64";2562;3026;5588
"3502";"San Joaquín";"65-69";2179;2619;4798
"3503";"San Joaquín";"70-74";1619;2246;3865
"3504";"San Joaquín";"75-80";2037;3575;5612
"3505";"San José  de Maipo";"20-24";624;560;1184
"3506";"San José  de Maipo";"25-29";587;518;1105
"3507";"San José  de Maipo";"30-34";573;528;1101
"3508";"San José  de Maipo";"35-39";579;509;1088
"3509";"San José  de Maipo";"40-44";543;486;1029
"3510";"San José  de Maipo";"45-49";558;541;1099
"3511";"San José  de Maipo";"50-54";487;490;977
"3512";"San José  de Maipo";"55-59";412;421;833
"3513";"San José  de Maipo";"60-64";340;346;686
"3514";"San José  de Maipo";"65-69";323;268;591
"3515";"San José  de Maipo";"70-74";206;169;375
"3516";"San José  de Maipo";"75-80";249;326;575
"3517";"San Juan de la Costa";"20-24";321;236;557
"3518";"San Juan de la Costa";"25-29";291;241;532
"3519";"San Juan de la Costa";"30-34";245;179;424
"3520";"San Juan de la Costa";"35-39";276;222;498
"3521";"San Juan de la Costa";"40-44";308;249;557
"3522";"San Juan de la Costa";"45-49";352;254;606
"3523";"San Juan de la Costa";"50-54";327;224;551
"3524";"San Juan de la Costa";"55-59";274;209;483
"3525";"San Juan de la Costa";"60-64";264;157;421
"3526";"San Juan de la Costa";"65-69";232;135;367
"3527";"San Juan de la Costa";"70-74";146;124;270
"3528";"San Juan de la Costa";"75-80";224;155;379
"3529";"San Miguel";"20-24";4724;3836;8560
"3530";"San Miguel";"25-29";4652;3974;8626
"3531";"San Miguel";"30-34";4023;3625;7648
"3532";"San Miguel";"35-39";3534;3357;6891
"3533";"San Miguel";"40-44";3362;3762;7124
"3534";"San Miguel";"45-49";3570;3943;7513
"3535";"San Miguel";"50-54";3536;4044;7580
"3536";"San Miguel";"55-59";3040;3634;6674
"3537";"San Miguel";"60-64";2560;3088;5648
"3538";"San Miguel";"65-69";2207;2829;5036
"3539";"San Miguel";"70-74";1664;2385;4049
"3540";"San Miguel";"75-80";2319;4444;6763
"3541";"San Nicolás";"20-24";433;437;870
"3542";"San Nicolás";"25-29";412;421;833
"3543";"San Nicolás";"30-34";396;382;778
"3544";"San Nicolás";"35-39";402;346;748
"3545";"San Nicolás";"40-44";389;361;750
"3546";"San Nicolás";"45-49";455;404;859
"3547";"San Nicolás";"50-54";430;381;811
"3548";"San Nicolás";"55-59";384;367;751
"3549";"San Nicolás";"60-64";300;297;597
"3550";"San Nicolás";"65-69";246;219;465
"3551";"San Nicolás";"70-74";176;160;336
"3552";"San Nicolás";"75-80";218;291;509
"3553";"San Pablo";"20-24";355;325;680
"3554";"San Pablo";"25-29";293;298;591
"3555";"San Pablo";"30-34";264;306;570
"3556";"San Pablo";"35-39";378;317;695
"3557";"San Pablo";"40-44";404;348;752
"3558";"San Pablo";"45-49";445;431;876
"3559";"San Pablo";"50-54";439;362;801
"3560";"San Pablo";"55-59";335;301;636
"3561";"San Pablo";"60-64";310;268;578
"3562";"San Pablo";"65-69";253;197;450
"3563";"San Pablo";"70-74";217;203;420
"3564";"San Pablo";"75-80";247;340;587
"3565";"San Pedro";"20-24";319;300;619
"3566";"San Pedro";"25-29";350;318;668
"3567";"San Pedro";"30-34";345;285;630
"3568";"San Pedro";"35-39";332;265;597
"3569";"San Pedro";"40-44";397;289;686
"3570";"San Pedro";"45-49";372;302;674
"3571";"San Pedro";"50-54";400;286;686
"3572";"San Pedro";"55-59";272;241;513
"3573";"San Pedro";"60-64";317;220;537
"3574";"San Pedro";"65-69";240;165;405
"3575";"San Pedro";"70-74";158;144;302
"3576";"San Pedro";"75-80";225;243;468
"3577";"San Pedro de  la Paz";"20-24";6009;6130;12139
"3578";"San Pedro de  la Paz";"25-29";5411;5324;10735
"3579";"San Pedro de  la Paz";"30-34";3949;4250;8199
"3580";"San Pedro de  la Paz";"35-39";3718;4019;7737
"3581";"San Pedro de  la Paz";"40-44";4035;4584;8619
"3582";"San Pedro de  la Paz";"45-49";4368;4915;9283
"3583";"San Pedro de  la Paz";"50-54";4254;4467;8721
"3584";"San Pedro de  la Paz";"55-59";3123;3413;6536
"3585";"San Pedro de  la Paz";"60-64";2116;2454;4570
"3586";"San Pedro de  la Paz";"65-69";1649;1849;3498
"3587";"San Pedro de  la Paz";"70-74";1008;1299;2307
"3588";"San Pedro de  la Paz";"75-80";1185;2117;3302
"3589";"San Pedro de Atacama";"20-24";310;299;609
"3590";"San Pedro de Atacama";"25-29";416;287;703
"3591";"San Pedro de Atacama";"30-34";401;244;645
"3592";"San Pedro de Atacama";"35-39";331;190;521
"3593";"San Pedro de Atacama";"40-44";257;163;420
"3594";"San Pedro de Atacama";"45-49";241;172;413
"3595";"San Pedro de Atacama";"50-54";229;156;385
"3596";"San Pedro de Atacama";"55-59";218;182;400
"3597";"San Pedro de Atacama";"60-64";191;161;352
"3598";"San Pedro de Atacama";"65-69";114;140;254
"3599";"San Pedro de Atacama";"70-74";60;71;131
"3600";"San Pedro de Atacama";"75-80";109;161;270
"3601";"San Rafael";"20-24";397;383;780
"3602";"San Rafael";"25-29";354;359;713
"3603";"San Rafael";"30-34";330;317;647
"3604";"San Rafael";"35-39";282;294;576
"3605";"San Rafael";"40-44";331;297;628
"3606";"San Rafael";"45-49";342;314;656
"3607";"San Rafael";"50-54";331;334;665
"3608";"San Rafael";"55-59";301;270;571
"3609";"San Rafael";"60-64";274;217;491
"3610";"San Rafael";"65-69";159;172;331
"3611";"San Rafael";"70-74";135;109;244
"3612";"San Rafael";"75-80";183;207;390
"3613";"San Ramón";"20-24";4093;4037;8130
"3614";"San Ramón";"25-29";4461;4218;8679
"3615";"San Ramón";"30-34";4267;3907;8174
"3616";"San Ramón";"35-39";3442;3361;6803
"3617";"San Ramón";"40-44";2909;2773;5682
"3618";"San Ramón";"45-49";2957;3006;5963
"3619";"San Ramón";"50-54";3228;3650;6878
"3620";"San Ramón";"55-59";3118;3542;6660
"3621";"San Ramón";"60-64";2493;2752;5245
"3622";"San Ramón";"65-69";1876;2142;4018
"3623";"San Ramón";"70-74";1127;1376;2503
"3624";"San Ramón";"75-80";1204;1990;3194
"3625";"San Rosendo";"20-24";144;146;290
"3626";"San Rosendo";"25-29";138;137;275
"3627";"San Rosendo";"30-34";103;115;218
"3628";"San Rosendo";"35-39";106;123;229
"3629";"San Rosendo";"40-44";127;143;270
"3630";"San Rosendo";"45-49";157;152;309
"3631";"San Rosendo";"50-54";155;130;285
"3632";"San Rosendo";"55-59";131;150;281
"3633";"San Rosendo";"60-64";102;114;216
"3634";"San Rosendo";"65-69";77;75;152
"3635";"San Rosendo";"70-74";49;71;120
"3636";"San Rosendo";"75-80";57;119;176
"3637";"San Vicente";"20-24";1723;1737;3460
"3638";"San Vicente";"25-29";1484;1437;2921
"3639";"San Vicente";"30-34";1398;1332;2730
"3640";"San Vicente";"35-39";1636;1698;3334
"3641";"San Vicente";"40-44";1749;1712;3461
"3642";"San Vicente";"45-49";1834;1787;3621
"3643";"San Vicente";"50-54";1718;1590;3308
"3644";"San Vicente";"55-59";1432;1297;2729
"3645";"San Vicente";"60-64";1158;1125;2283
"3646";"San Vicente";"65-69";954;922;1876
"3647";"San Vicente";"70-74";670;702;1372
"3648";"San Vicente";"75-80";971;1162;2133
"3649";"Santa Bárbara";"20-24";486;500;986
"3650";"Santa Bárbara";"25-29";440;431;871
"3651";"Santa Bárbara";"30-34";386;387;773
"3652";"Santa Bárbara";"35-39";385;377;762
"3653";"Santa Bárbara";"40-44";448;426;874
"3654";"Santa Bárbara";"45-49";446;449;895
"3655";"Santa Bárbara";"50-54";443;404;847
"3656";"Santa Bárbara";"55-59";400;353;753
"3657";"Santa Bárbara";"60-64";322;319;641
"3658";"Santa Bárbara";"65-69";236;227;463
"3659";"Santa Bárbara";"70-74";261;220;481
"3660";"Santa Bárbara";"75-80";307;368;675
"3661";"Santa Cruz";"20-24";1453;1384;2837
"3662";"Santa Cruz";"25-29";1250;1218;2468
"3663";"Santa Cruz";"30-34";1142;1159;2301
"3664";"Santa Cruz";"35-39";1283;1254;2537
"3665";"Santa Cruz";"40-44";1385;1341;2726
"3666";"Santa Cruz";"45-49";1345;1364;2709
"3667";"Santa Cruz";"50-54";1260;1312;2572
"3668";"Santa Cruz";"55-59";1011;1039;2050
"3669";"Santa Cruz";"60-64";889;929;1818
"3670";"Santa Cruz";"65-69";707;788;1495
"3671";"Santa Cruz";"70-74";543;555;1098
"3672";"Santa Cruz";"75-80";777;1024;1801
"3673";"Santa Juana";"20-24";426;477;903
"3674";"Santa Juana";"25-29";468;493;961
"3675";"Santa Juana";"30-34";461;456;917
"3676";"Santa Juana";"35-39";433;430;863
"3677";"Santa Juana";"40-44";463;467;930
"3678";"Santa Juana";"45-49";495;432;927
"3679";"Santa Juana";"50-54";513;400;913
"3680";"Santa Juana";"55-59";410;408;818
"3681";"Santa Juana";"60-64";411;330;741
"3682";"Santa Juana";"65-69";293;328;621
"3683";"Santa Juana";"70-74";241;238;479
"3684";"Santa Juana";"75-80";329;443;772
"3685";"Santa María";"20-24";637;621;1258
"3686";"Santa María";"25-29";610;619;1229
"3687";"Santa María";"30-34";499;504;1003
"3688";"Santa María";"35-39";551;587;1138
"3689";"Santa María";"40-44";503;484;987
"3690";"Santa María";"45-49";527;534;1061
"3691";"Santa María";"50-54";490;453;943
"3692";"Santa María";"55-59";442;442;884
"3693";"Santa María";"60-64";365;315;680
"3694";"Santa María";"65-69";253;295;548
"3695";"Santa María";"70-74";205;195;400
"3696";"Santa María";"75-80";292;379;671
"3697";"Santiago";"20-24";17840;14878;32718
"3698";"Santiago";"25-29";21355;17893;39248
"3699";"Santiago";"30-34";17100;13315;30415
"3700";"Santiago";"35-39";12717;10647;23364
"3701";"Santiago";"40-44";10899;10246;21145
"3702";"Santiago";"45-49";10616;10731;21347
"3703";"Santiago";"50-54";10207;11223;21430
"3704";"Santiago";"55-59";8903;10163;19066
"3705";"Santiago";"60-64";7363;9180;16543
"3706";"Santiago";"65-69";6116;8281;14397
"3707";"Santiago";"70-74";4685;6907;11592
"3708";"Santiago";"75-80";6632;14616;21248
"3709";"Santo Domingo";"20-24";300;338;638
"3710";"Santo Domingo";"25-29";371;349;720
"3711";"Santo Domingo";"30-34";367;349;716
"3712";"Santo Domingo";"35-39";322;287;609
"3713";"Santo Domingo";"40-44";354;308;662
"3714";"Santo Domingo";"45-49";335;323;658
"3715";"Santo Domingo";"50-54";316;287;603
"3716";"Santo Domingo";"55-59";257;257;514
"3717";"Santo Domingo";"60-64";214;187;401
"3718";"Santo Domingo";"65-69";173;165;338
"3719";"Santo Domingo";"70-74";130;141;271
"3720";"Santo Domingo";"75-80";190;192;382
"3721";"Sierra Gorda";"20-24";149;69;218
"3722";"Sierra Gorda";"25-29";301;62;363
"3723";"Sierra Gorda";"30-34";348;70;418
"3724";"Sierra Gorda";"35-39";286;54;340
"3725";"Sierra Gorda";"40-44";259;49;308
"3726";"Sierra Gorda";"45-49";246;28;274
"3727";"Sierra Gorda";"50-54";208;33;241
"3728";"Sierra Gorda";"55-59";140;30;170
"3729";"Sierra Gorda";"60-64";73;21;94
"3730";"Sierra Gorda";"65-69";28;21;49
"3731";"Sierra Gorda";"70-74";11;9;20
"3732";"Sierra Gorda";"75-80";19;15;34
"3733";"Talagante";"20-24";2800;2670;5470
"3734";"Talagante";"25-29";2702;2693;5395
"3735";"Talagante";"30-34";2680;2799;5479
"3736";"Talagante";"35-39";2722;2878;5600
"3737";"Talagante";"40-44";2738;2591;5329
"3738";"Talagante";"45-49";2399;2317;4716
"3739";"Talagante";"50-54";2044;2101;4145
"3740";"Talagante";"55-59";1507;1713;3220
"3741";"Talagante";"60-64";1264;1270;2534
"3742";"Talagante";"65-69";963;1067;2030
"3743";"Talagante";"70-74";633;716;1349
"3744";"Talagante";"75-80";737;1080;1817
"3745";"Talca";"20-24";11152;11416;22568
"3746";"Talca";"25-29";8896;9433;18329
"3747";"Talca";"30-34";7027;7453;14480
"3748";"Talca";"35-39";7157;7886;15043
"3749";"Talca";"40-44";7431;8546;15977
"3750";"Talca";"45-49";8333;9362;17695
"3751";"Talca";"50-54";7554;8515;16069
"3752";"Talca";"55-59";6022;7020;13042
"3753";"Talca";"60-64";4570;5204;9774
"3754";"Talca";"65-69";3293;4113;7406
"3755";"Talca";"70-74";2351;3320;5671
"3756";"Talca";"75-80";2836;5153;7989
"3757";"Talcahuano";"20-24";8956;7931;16887
"3758";"Talcahuano";"25-29";7375;7168;14543
"3759";"Talcahuano";"30-34";5664;5855;11519
"3760";"Talcahuano";"35-39";5652;6173;11825
"3761";"Talcahuano";"40-44";6638;7185;13823
"3762";"Talcahuano";"45-49";6807;7158;13965
"3763";"Talcahuano";"50-54";5806;6143;11949
"3764";"Talcahuano";"55-59";4293;4770;9063
"3765";"Talcahuano";"60-64";3183;3772;6955
"3766";"Talcahuano";"65-69";2591;3254;5845
"3767";"Talcahuano";"70-74";1890;2635;4525
"3768";"Talcahuano";"75-80";2196;3770;5966
"3769";"Taltal";"20-24";432;452;884
"3770";"Taltal";"25-29";553;403;956
"3771";"Taltal";"30-34";581;404;985
"3772";"Taltal";"35-39";633;431;1064
"3773";"Taltal";"40-44";591;388;979
"3774";"Taltal";"45-49";567;378;945
"3775";"Taltal";"50-54";466;323;789
"3776";"Taltal";"55-59";432;324;756
"3777";"Taltal";"60-64";343;208;551
"3778";"Taltal";"65-69";275;179;454
"3779";"Taltal";"70-74";125;132;257
"3780";"Taltal";"75-80";187;190;377
"3781";"Temuco";"20-24";15409;16388;31797
"3782";"Temuco";"25-29";12881;14102;26983
"3783";"Temuco";"30-34";9251;10357;19608
"3784";"Temuco";"35-39";8549;9763;18312
"3785";"Temuco";"40-44";8970;10548;19518
"3786";"Temuco";"45-49";9204;10791;19995
"3787";"Temuco";"50-54";8282;9479;17761
"3788";"Temuco";"55-59";6483;7411;13894
"3789";"Temuco";"60-64";4643;5858;10501
"3790";"Temuco";"65-69";3387;4707;8094
"3791";"Temuco";"70-74";2571;3869;6440
"3792";"Temuco";"75-80";3244;6853;10097
"3793";"Teno";"20-24";1280;1178;2458
"3794";"Teno";"25-29";1060;1013;2073
"3795";"Teno";"30-34";974;930;1904
"3796";"Teno";"35-39";1142;997;2139
"3797";"Teno";"40-44";1078;958;2036
"3798";"Teno";"45-49";1066;950;2016
"3799";"Teno";"50-54";1013;818;1831
"3800";"Teno";"55-59";835;729;1564
"3801";"Teno";"60-64";708;609;1317
"3802";"Teno";"65-69";531;464;995
"3803";"Teno";"70-74";387;372;759
"3804";"Teno";"75-80";458;504;962
"3805";"Teodoro Schmidt";"20-24";659;561;1220
"3806";"Teodoro Schmidt";"25-29";609;564;1173
"3807";"Teodoro Schmidt";"30-34";522;501;1023
"3808";"Teodoro Schmidt";"35-39";556;513;1069
"3809";"Teodoro Schmidt";"40-44";585;545;1130
"3810";"Teodoro Schmidt";"45-49";653;517;1170
"3811";"Teodoro Schmidt";"50-54";613;515;1128
"3812";"Teodoro Schmidt";"55-59";532;454;986
"3813";"Teodoro Schmidt";"60-64";412;378;790
"3814";"Teodoro Schmidt";"65-69";312;315;627
"3815";"Teodoro Schmidt";"70-74";254;267;521
"3816";"Teodoro Schmidt";"75-80";374;491;865
"3817";"Tierra Amarilla";"20-24";997;662;1659
"3818";"Tierra Amarilla";"25-29";928;598;1526
"3819";"Tierra Amarilla";"30-34";796;482;1278
"3820";"Tierra Amarilla";"35-39";760;474;1234
"3821";"Tierra Amarilla";"40-44";737;481;1218
"3822";"Tierra Amarilla";"45-49";654;476;1130
"3823";"Tierra Amarilla";"50-54";565;393;958
"3824";"Tierra Amarilla";"55-59";459;303;762
"3825";"Tierra Amarilla";"60-64";348;220;568
"3826";"Tierra Amarilla";"65-69";227;178;405
"3827";"Tierra Amarilla";"70-74";151;119;270
"3828";"Tierra Amarilla";"75-80";213;185;398
"3829";"Tiltil";"20-24";609;577;1186
"3830";"Tiltil";"25-29";681;633;1314
"3831";"Tiltil";"30-34";693;611;1304
"3832";"Tiltil";"35-39";735;631;1366
"3833";"Tiltil";"40-44";618;544;1162
"3834";"Tiltil";"45-49";557;526;1083
"3835";"Tiltil";"50-54";606;515;1121
"3836";"Tiltil";"55-59";433;415;848
"3837";"Tiltil";"60-64";402;320;722
"3838";"Tiltil";"65-69";318;304;622
"3839";"Tiltil";"70-74";273;221;494
"3840";"Tiltil";"75-80";235;279;514
"3841";"Timaukel";"20-24";12;3;15
"3842";"Timaukel";"25-29";16;5;21
"3843";"Timaukel";"30-34";19;2;21
"3844";"Timaukel";"35-39";17;4;21
"3845";"Timaukel";"40-44";12;3;15
"3846";"Timaukel";"45-49";17;2;19
"3847";"Timaukel";"50-54";19;10;29
"3848";"Timaukel";"55-59";12;9;21
"3849";"Timaukel";"60-64";7;3;10
"3850";"Timaukel";"65-69";4;3;7
"3851";"Timaukel";"70-74";2;2;4
"3852";"Timaukel";"75-80";1;1;2
"3853";"Tirúa";"20-24";526;474;1000
"3854";"Tirúa";"25-29";449;396;845
"3855";"Tirúa";"30-34";353;343;696
"3856";"Tirúa";"35-39";310;274;584
"3857";"Tirúa";"40-44";368;297;665
"3858";"Tirúa";"45-49";352;323;675
"3859";"Tirúa";"50-54";331;289;620
"3860";"Tirúa";"55-59";268;211;479
"3861";"Tirúa";"60-64";239;159;398
"3862";"Tirúa";"65-69";177;169;346
"3863";"Tirúa";"70-74";111;111;222
"3864";"Tirúa";"75-80";182;162;344
"3865";"Tocopilla";"20-24";829;835;1664
"3866";"Tocopilla";"25-29";976;873;1849
"3867";"Tocopilla";"30-34";878;972;1850
"3868";"Tocopilla";"35-39";969;972;1941
"3869";"Tocopilla";"40-44";974;875;1849
"3870";"Tocopilla";"45-49";1051;915;1966
"3871";"Tocopilla";"50-54";1030;912;1942
"3872";"Tocopilla";"55-59";962;798;1760
"3873";"Tocopilla";"60-64";731;636;1367
"3874";"Tocopilla";"65-69";451;532;983
"3875";"Tocopilla";"70-74";317;380;697
"3876";"Tocopilla";"75-80";319;586;905
"3877";"Toltén";"20-24";400;393;793
"3878";"Toltén";"25-29";447;426;873
"3879";"Toltén";"30-34";363;355;718
"3880";"Toltén";"35-39";390;380;770
"3881";"Toltén";"40-44";433;354;787
"3882";"Toltén";"45-49";426;353;779
"3883";"Toltén";"50-54";401;317;718
"3884";"Toltén";"55-59";315;294;609
"3885";"Toltén";"60-64";314;247;561
"3886";"Toltén";"65-69";236;235;471
"3887";"Toltén";"70-74";180;176;356
"3888";"Toltén";"75-80";258;352;610
"3889";"Tomé";"20-24";2184;2365;4549
"3890";"Tomé";"25-29";2052;2068;4120
"3891";"Tomé";"30-34";1760;1896;3656
"3892";"Tomé";"35-39";1616;1782;3398
"3893";"Tomé";"40-44";1895;2041;3936
"3894";"Tomé";"45-49";1824;1990;3814
"3895";"Tomé";"50-54";1856;2071;3927
"3896";"Tomé";"55-59";1615;1851;3466
"3897";"Tomé";"60-64";1294;1469;2763
"3898";"Tomé";"65-69";1020;1198;2218
"3899";"Tomé";"70-74";771;956;1727
"3900";"Tomé";"75-80";1054;1658;2712
"3901";"Torres del Paine";"20-24";39;27;66
"3902";"Torres del Paine";"25-29";87;41;128
"3903";"Torres del Paine";"30-34";46;19;65
"3904";"Torres del Paine";"35-39";58;18;76
"3905";"Torres del Paine";"40-44";43;10;53
"3906";"Torres del Paine";"45-49";50;9;59
"3907";"Torres del Paine";"50-54";52;23;75
"3908";"Torres del Paine";"55-59";44;12;56
"3909";"Torres del Paine";"60-64";35;10;45
"3910";"Torres del Paine";"65-69";19;1;20
"3911";"Torres del Paine";"70-74";5;1;6
"3912";"Torres del Paine";"75-80";2;0;2
"3913";"Tortel";"20-24";52;18;70
"3914";"Tortel";"25-29";41;17;58
"3915";"Tortel";"30-34";33;19;52
"3916";"Tortel";"35-39";31;23;54
"3917";"Tortel";"40-44";40;9;49
"3918";"Tortel";"45-49";28;13;41
"3919";"Tortel";"50-54";21;13;34
"3920";"Tortel";"55-59";21;21;42
"3921";"Tortel";"60-64";3;9;12
"3922";"Tortel";"65-69";9;2;11
"3923";"Tortel";"70-74";6;1;7
"3924";"Tortel";"75-80";7;3;10
"3925";"Traiguén";"20-24";767;692;1459
"3926";"Traiguén";"25-29";609;618;1227
"3927";"Traiguén";"30-34";528;596;1124
"3928";"Traiguén";"35-39";626;680;1306
"3929";"Traiguén";"40-44";697;716;1413
"3930";"Traiguén";"45-49";737;738;1475
"3931";"Traiguén";"50-54";679;691;1370
"3932";"Traiguén";"55-59";561;546;1107
"3933";"Traiguén";"60-64";499;491;990
"3934";"Traiguén";"65-69";398;433;831
"3935";"Traiguén";"70-74";319;388;707
"3936";"Traiguén";"75-80";433;649;1082
"3937";"Treguaco";"20-24";186;166;352
"3938";"Treguaco";"25-29";208;176;384
"3939";"Treguaco";"30-34";184;192;376
"3940";"Treguaco";"35-39";167;139;306
"3941";"Treguaco";"40-44";193;186;379
"3942";"Treguaco";"45-49";230;188;418
"3943";"Treguaco";"50-54";219;169;388
"3944";"Treguaco";"55-59";182;166;348
"3945";"Treguaco";"60-64";179;131;310
"3946";"Treguaco";"65-69";126;116;242
"3947";"Treguaco";"70-74";101;84;185
"3948";"Treguaco";"75-80";125;162;287
"3949";"Tucapel";"20-24";531;487;1018
"3950";"Tucapel";"25-29";470;491;961
"3951";"Tucapel";"30-34";471;468;939
"3952";"Tucapel";"35-39";463;381;844
"3953";"Tucapel";"40-44";510;463;973
"3954";"Tucapel";"45-49";439;499;938
"3955";"Tucapel";"50-54";513;456;969
"3956";"Tucapel";"55-59";392;416;808
"3957";"Tucapel";"60-64";403;407;810
"3958";"Tucapel";"65-69";345;350;695
"3959";"Tucapel";"70-74";248;247;495
"3960";"Tucapel";"75-80";387;475;862
"3961";"Valdivia";"20-24";9345;8753;18098
"3962";"Valdivia";"25-29";7421;7185;14606
"3963";"Valdivia";"30-34";5451;5445;10896
"3964";"Valdivia";"35-39";5012;5272;10284
"3965";"Valdivia";"40-44";5414;5817;11231
"3966";"Valdivia";"45-49";6024;6303;12327
"3967";"Valdivia";"50-54";5302;5544;10846
"3968";"Valdivia";"55-59";4101;4517;8618
"3969";"Valdivia";"60-64";3020;3645;6665
"3970";"Valdivia";"65-69";2266;2945;5211
"3971";"Valdivia";"70-74";1728;2573;4301
"3972";"Valdivia";"75-80";2340;4203;6543
"3973";"Vallenar";"20-24";1912;1876;3788
"3974";"Vallenar";"25-29";1746;1865;3611
"3975";"Vallenar";"30-34";1617;1744;3361
"3976";"Vallenar";"35-39";1783;1816;3599
"3977";"Vallenar";"40-44";1708;1830;3538
"3978";"Vallenar";"45-49";1864;1833;3697
"3979";"Vallenar";"50-54";1724;1868;3592
"3980";"Vallenar";"55-59";1546;1611;3157
"3981";"Vallenar";"60-64";1163;1234;2397
"3982";"Vallenar";"65-69";883;966;1849
"3983";"Vallenar";"70-74";701;729;1430
"3984";"Vallenar";"75-80";948;1204;2152
"3985";"Valparaíso";"20-24";14902;13060;27962
"3986";"Valparaíso";"25-29";13923;12130;26053
"3987";"Valparaíso";"30-34";11138;10061;21199
"3988";"Valparaíso";"35-39";9155;8870;18025
"3989";"Valparaíso";"40-44";9070;9251;18321
"3990";"Valparaíso";"45-49";9725;10582;20307
"3991";"Valparaíso";"50-54";9660;10940;20600
"3992";"Valparaíso";"55-59";8072;9135;17207
"3993";"Valparaíso";"60-64";6144;7441;13585
"3994";"Valparaíso";"65-69";4877;6435;11312
"3995";"Valparaíso";"70-74";3830;5625;9455
"3996";"Valparaíso";"75-80";4952;9810;14762
"3997";"Vichuquén";"20-24";186;159;345
"3998";"Vichuquén";"25-29";208;196;404
"3999";"Vichuquén";"30-34";189;179;368
"4000";"Vichuquén";"35-39";190;167;357
"4001";"Vichuquén";"40-44";195;165;360
"4002";"Vichuquén";"45-49";202;177;379
"4003";"Vichuquén";"50-54";224;137;361
"4004";"Vichuquén";"55-59";171;161;332
"4005";"Vichuquén";"60-64";146;112;258
"4006";"Vichuquén";"65-69";96;97;193
"4007";"Vichuquén";"70-74";84;87;171
"4008";"Vichuquén";"75-80";112;132;244
"4009";"Victoria";"20-24";1446;1351;2797
"4010";"Victoria";"25-29";1181;1308;2489
"4011";"Victoria";"30-34";1046;1123;2169
"4012";"Victoria";"35-39";1135;1190;2325
"4013";"Victoria";"40-44";1203;1218;2421
"4014";"Victoria";"45-49";1215;1327;2542
"4015";"Victoria";"50-54";1162;1129;2291
"4016";"Victoria";"55-59";922;1056;1978
"4017";"Victoria";"60-64";760;814;1574
"4018";"Victoria";"65-69";583;703;1286
"4019";"Victoria";"70-74";545;596;1141
"4020";"Victoria";"75-80";654;1036;1690
"4021";"Vicuña";"20-24";1005;1015;2020
"4022";"Vicuña";"25-29";1063;984;2047
"4023";"Vicuña";"30-34";1012;918;1930
"4024";"Vicuña";"35-39";1004;878;1882
"4025";"Vicuña";"40-44";1036;884;1920
"4026";"Vicuña";"45-49";992;838;1830
"4027";"Vicuña";"50-54";891;735;1626
"4028";"Vicuña";"55-59";752;696;1448
"4029";"Vicuña";"60-64";565;597;1162
"4030";"Vicuña";"65-69";456;422;878
"4031";"Vicuña";"70-74";349;355;704
"4032";"Vicuña";"75-80";509;672;1181
"4033";"Vilcún";"20-24";1162;1171;2333
"4034";"Vilcún";"25-29";1105;1029;2134
"4035";"Vilcún";"30-34";868;890;1758
"4036";"Vilcún";"35-39";854;855;1709
"4037";"Vilcún";"40-44";915;909;1824
"4038";"Vilcún";"45-49";890;846;1736
"4039";"Vilcún";"50-54";889;831;1720
"4040";"Vilcún";"55-59";784;687;1471
"4041";"Vilcún";"60-64";566;626;1192
"4042";"Vilcún";"65-69";520;546;1066
"4043";"Vilcún";"70-74";379;366;745
"4044";"Vilcún";"75-80";483;619;1102
"4045";"Villa Alegre";"20-24";627;597;1224
"4046";"Villa Alegre";"25-29";503;521;1024
"4047";"Villa Alegre";"30-34";450;481;931
"4048";"Villa Alegre";"35-39";450;460;910
"4049";"Villa Alegre";"40-44";503;511;1014
"4050";"Villa Alegre";"45-49";602;572;1174
"4051";"Villa Alegre";"50-54";538;561;1099
"4052";"Villa Alegre";"55-59";572;495;1067
"4053";"Villa Alegre";"60-64";413;412;825
"4054";"Villa Alegre";"65-69";334;306;640
"4055";"Villa Alegre";"70-74";241;248;489
"4056";"Villa Alegre";"75-80";342;425;767
"4057";"Villa Alemana";"20-24";5064;5211;10275
"4058";"Villa Alemana";"25-29";5276;5523;10799
"4059";"Villa Alemana";"30-34";4779;4832;9611
"4060";"Villa Alemana";"35-39";4201;4404;8605
"4061";"Villa Alemana";"40-44";4227;4766;8993
"4062";"Villa Alemana";"45-49";4461;4883;9344
"4063";"Villa Alemana";"50-54";4286;4741;9027
"4064";"Villa Alemana";"55-59";3376;4022;7398
"4065";"Villa Alemana";"60-64";2666;3227;5893
"4066";"Villa Alemana";"65-69";2227;2771;4998
"4067";"Villa Alemana";"70-74";1644;2179;3823
"4068";"Villa Alemana";"75-80";2213;3989;6202
"4069";"Villarrica";"20-24";2148;2191;4339
"4070";"Villarrica";"25-29";2073;2188;4261
"4071";"Villarrica";"30-34";1919;1937;3856
"4072";"Villarrica";"35-39";1839;1869;3708
"4073";"Villarrica";"40-44";1947;1945;3892
"4074";"Villarrica";"45-49";1842;1771;3613
"4075";"Villarrica";"50-54";1662;1603;3265
"4076";"Villarrica";"55-59";1377;1290;2667
"4077";"Villarrica";"60-64";1105;1059;2164
"4078";"Villarrica";"65-69";899;908;1807
"4079";"Villarrica";"70-74";655;732;1387
"4080";"Villarrica";"75-80";1049;1257;2306
"4081";"Viña del Mar";"20-24";16242;14973;31215
"4082";"Viña del Mar";"25-29";13828;12727;26555
"4083";"Viña del Mar";"30-34";10838;10317;21155
"4084";"Viña del Mar";"35-39";9142;9568;18710
"4085";"Viña del Mar";"40-44";9677;10490;20167
"4086";"Viña del Mar";"45-49";10417;11904;22321
"4087";"Viña del Mar";"50-54";10028;11927;21955
"4088";"Viña del Mar";"55-59";8546;10241;18787
"4089";"Viña del Mar";"60-64";6942;8569;15511
"4090";"Viña del Mar";"65-69";5604;7723;13327
"4091";"Viña del Mar";"70-74";4463;6356;10819
"4092";"Viña del Mar";"75-80";6197;11764;17961
"4093";"Vitacura";"20-24";3290;4306;7596
"4094";"Vitacura";"25-29";2985;4193;7178
"4095";"Vitacura";"30-34";2550;3559;6109
"4096";"Vitacura";"35-39";2177;2936;5113
"4097";"Vitacura";"40-44";2152;3215;5367
"4098";"Vitacura";"45-49";2529;3940;6469
"4099";"Vitacura";"50-54";2651;4289;6940
"4100";"Vitacura";"55-59";2821;4161;6982
"4101";"Vitacura";"60-64";2476;2870;5346
"4102";"Vitacura";"65-69";1788;2115;3903
"4103";"Vitacura";"70-74";1218;1412;2630
"4104";"Vitacura";"75-80";1741;2956;4697
"4105";"Yerbas Buenas";"20-24";825;808;1633
"4106";"Yerbas Buenas";"25-29";615;642;1257
"4107";"Yerbas Buenas";"30-34";575;577;1152
"4108";"Yerbas Buenas";"35-39";615;589;1204
"4109";"Yerbas Buenas";"40-44";650;591;1241
"4110";"Yerbas Buenas";"45-49";694;644;1338
"4111";"Yerbas Buenas";"50-54";652;562;1214
"4112";"Yerbas Buenas";"55-59";603;444;1047
"4113";"Yerbas Buenas";"60-64";443;351;794
"4114";"Yerbas Buenas";"65-69";300;259;559
"4115";"Yerbas Buenas";"70-74";247;222;469
"4116";"Yerbas Buenas";"75-80";324;339;663
"4117";"Yumbel";"20-24";934;825;1759
"4118";"Yumbel";"25-29";786;708;1494
"4119";"Yumbel";"30-34";644;693;1337
"4120";"Yumbel";"35-39";651;650;1301
"4121";"Yumbel";"40-44";766;754;1520
"4122";"Yumbel";"45-49";772;699;1471
"4123";"Yumbel";"50-54";783;711;1494
"4124";"Yumbel";"55-59";675;656;1331
"4125";"Yumbel";"60-64";686;643;1329
"4126";"Yumbel";"65-69";512;510;1022
"4127";"Yumbel";"70-74";419;419;838
"4128";"Yumbel";"75-80";511;686;1197
"4129";"Yungay";"20-24";713;639;1352
"4130";"Yungay";"25-29";726;664;1390
"4131";"Yungay";"30-34";670;642;1312
"4132";"Yungay";"35-39";641;552;1193
"4133";"Yungay";"40-44";720;589;1309
"4134";"Yungay";"45-49";635;609;1244
"4135";"Yungay";"50-54";620;573;1193
"4136";"Yungay";"55-59";525;464;989
"4137";"Yungay";"60-64";450;416;866
"4138";"Yungay";"65-69";410;403;813
"4139";"Yungay";"70-74";255;329;584
"4140";"Yungay";"75-80";400;512;912
"4141";"Zapallar";"20-24";226;204;430
"4142";"Zapallar";"25-29";240;260;500
"4143";"Zapallar";"30-34";219;204;423
"4144";"Zapallar";"35-39";243;201;444
"4145";"Zapallar";"40-44";248;212;460
"4146";"Zapallar";"45-49";226;212;438
"4147";"Zapallar";"50-54";202;199;401
"4148";"Zapallar";"55-59";179;184;363
"4149";"Zapallar";"60-64";142;130;272
"4150";"Zapallar";"65-69";132;113;245
"4151";"Zapallar";"70-74";82;103;185
"4152";"Zapallar";"75-80";134;146;280
"4153";"Algarrobo";"18-19";134;126;260
"4154";"Alhué";"18-19";75;80;155
"4155";"Alto Biobío";"18-19";73;115;188
"4156";"Alto del Carmen";"18-19";65;62;127
"4157";"Alto Hospicio";"18-19";1550;1586;3136
"4158";"Ancud";"18-19";656;769;1425
"4159";"Andacollo";"18-19";177;159;336
"4160";"Angol";"18-19";978;1018;1996
"4161";"Antártica";"18-19";0;0;0
"4162";"Antofagasta";"18-19";5822;5645;11467
"4163";"Antuco";"18-19";69;67;136
"4164";"Arauco";"18-19";611;609;1220
"4165";"Arica";"18-19";3464;3470;6934
"4166";"Aysén";"18-19";466;423;889
"4167";"Buín";"18-19";1260;1264;2524
"4168";"Bulnes";"18-19";373;346;719
"4169";"Cabildo";"18-19";326;318;644
"4170";"Cabo de Hornos";"18-19";25;18;43
"4171";"Cabrero";"18-19";441;432;873
"4172";"Calama";"18-19";2869;2682;5551
"4173";"Calbuco";"18-19";521;489;1010
"4174";"Caldera";"18-19";441;242;683
"4175";"Calera  de Tango";"18-19";338;345;683
"4176";"Calle Larga";"18-19";260;201;461
"4177";"Camarones";"18-19";10;9;19
"4178";"Camiña";"18-19";10;9;19
"4179";"Canela";"18-19";124;123;247
"4180";"Cañete";"18-19";558;546;1104
"4181";"Carahue";"18-19";480;491;971
"4182";"Cartagena";"18-19";266;278;544
"4183";"Casablanca";"18-19";394;401;795
"4184";"Castro";"18-19";794;806;1600
"4185";"Catemu";"18-19";233;219;452
"4186";"Cauquenes";"18-19";644;585;1229
"4187";"Cerrillos";"18-19";1208;1166;2374
"4188";"Cerro Navia";"18-19";2255;2299;4554
"4189";"Chaitén";"18-19";84;55;139
"4190";"Chanco";"18-19";146;132;278
"4191";"Chañaral";"18-19";188;194;382
"4192";"Chépica";"18-19";272;268;540
"4193";"Chiguayante";"18-19";1505;1558;3063
"4194";"Chile Chico";"18-19";63;74;137
"4195";"Chillán";"18-19";3163;2990;6153
"4196";"Chillán Viejo";"18-19";449;462;911
"4197";"Chimbarongo";"18-19";636;594;1230
"4198";"Cholchol";"18-19";273;258;531
"4199";"Chonchi";"18-19";310;220;530
"4200";"Cisnes";"18-19";46;66;112
"4201";"Cobquecura";"18-19";83;63;146
"4202";"Cochamó";"18-19";49;35;84
"4203";"Cochrane";"18-19";45;50;95
"4204";"Codegua";"18-19";234;242;476
"4205";"Coelemu";"18-19";252;245;497
"4206";"Coihueco";"18-19";417;428;845
"4207";"Coinco";"18-19";110;100;210
"4208";"Colbún";"18-19";333;319;652
"4209";"Colchane";"18-19";22;24;46
"4210";"Colina";"18-19";2452;1680;4132
"4211";"Collipulli";"18-19";398;393;791
"4212";"Coltauco";"18-19";307;291;598
"4213";"Combarbalá";"18-19";201;169;370
"4214";"Concepción";"18-19";3995;3705;7700
"4215";"Conchalí";"18-19";1917;1887;3804
"4216";"Concón";"18-19";736;675;1411
"4217";"Constitución";"18-19";814;782;1596
"4218";"Contulmo";"18-19";66;81;147
"4219";"Copiapó";"18-19";2764;2654;5418
"4220";"Coquimbo";"18-19";3729;3716;7445
"4221";"Coronel";"18-19";1861;1873;3734
"4222";"Corral";"18-19";101;71;172
"4223";"Coyhaique";"18-19";1086;1013;2099
"4224";"Cunco";"18-19";291;371;662
"4225";"Curacautín";"18-19";267;259;526
"4226";"Curacaví";"18-19";428;429;857
"4227";"Curaco de Vélez";"18-19";66;72;138
"4228";"Curanilahue";"18-19";547;542;1089
"4229";"Curarrehue";"18-19";125;114;239
"4230";"Curepto";"18-19";160;129;289
"4231";"Curicó";"18-19";2283;2212;4495
"4232";"Dalcahue";"18-19";198;208;406
"4233";"Diego de Almagro";"18-19";204;238;442
"4234";"Doñihue";"18-19";336;323;659
"4235";"El Bosque";"18-19";3339;3000;6339
"4236";"El Carmen";"18-19";206;200;406
"4237";"El Monte";"18-19";562;532;1094
"4238";"El Quisco";"18-19";150;147;297
"4239";"El Tabo";"18-19";122;113;235
"4240";"Empedrado";"18-19";62;65;127
"4241";"Ercilla";"18-19";177;144;321
"4242";"Estación Central";"18-19";1988;1842;3830
"4243";"Florida";"18-19";148;140;288
"4244";"Freire";"18-19";412;383;795
"4245";"Freirina";"18-19";118;105;223
"4246";"Fresia";"18-19";178;191;369
"4247";"Frutillar";"18-19";328;246;574
"4248";"Futaleufú";"18-19";20;26;46
"4249";"Futrono";"18-19";246;246;492
"4250";"Galvarino";"18-19";212;176;388
"4251";"General Lagos";"18-19";31;5;36
"4252";"Gorbea";"18-19";259;220;479
"4253";"Graneros";"18-19";527;536;1063
"4254";"Guaitecas";"18-19";15;13;28
"4255";"Hijuela";"18-19";282;271;553
"4256";"Hualaihué";"18-19";158;178;336
"4257";"Hualañé";"18-19";146;132;278
"4258";"Hualpén";"18-19";1645;1543;3188
"4259";"Hualqui";"18-19";368;384;752
"4260";"Huara";"18-19";51;40;91
"4261";"Huasco";"18-19";132;163;295
"4262";"Huechuraba";"18-19";1347;1318;2665
"4263";"Illapel";"18-19";624;553;1177
"4264";"Inpendencia";"18-19";961;950;1911
"4265";"Iquique";"18-19";3058;2955;6013
"4266";"Isla de  Pascua";"18-19";68;54;122
"4267";"Isla de Maipo";"18-19";534;505;1039
"4268";"Juan Fernández";"18-19";4;4;8
"4269";"La Calera";"18-19";837;870;1707
"4270";"La Cisterna";"18-19";1274;1253;2527
"4271";"La Cruz";"18-19";250;256;506
"4272";"La Estrella";"18-19";276;37;313
"4273";"La Florida";"18-19";6128;6151;12279
"4274";"La Granja";"18-19";2308;2273;4581
"4275";"La Higuera";"18-19";59;47;106
"4276";"La Ligua";"18-19";593;489;1082
"4277";"La Pintana";"18-19";3779;3766;7545
"4278";"La Reina";"18-19";1552;1535;3087
"4279";"La Serena";"18-19";3765;3387;7152
"4280";"La Unión";"18-19";826;631;1457
"4281";"Lago Ranco";"18-19";146;156;302
"4282";"Lago Verde";"18-19";6;3;9
"4283";"Laguna Blanca";"18-19";47;2;49
"4284";"Laja";"18-19";353;348;701
"4285";"Lampa";"18-19";1228;1199;2427
"4286";"Lanco";"18-19";279;334;613
"4287";"Las Cabras";"18-19";342;335;677
"4288";"Las Condes";"18-19";3783;3805;7588
"4289";"Lautaro";"18-19";710;626;1336
"4290";"Lebu";"18-19";445;468;913
"4291";"Licantén";"18-19";107;100;207
"4292";"Limache";"18-19";650;634;1284
"4293";"Linares";"18-19";1601;1478;3079
"4294";"Litueche";"18-19";99;92;191
"4295";"Llaillay";"18-19";388;386;774
"4296";"Llanquihue";"18-19";270;278;548
"4297";"Lo Barnechea";"18-19";1653;1742;3395
"4298";"Lo Espejo";"18-19";1834;1853;3687
"4299";"Lo Prado";"18-19";1487;1494;2981
"4300";"Lolol";"18-19";112;100;212
"4301";"Loncoche";"18-19";368;377;745
"4302";"Longaví";"18-19";509;481;990
"4303";"Lonquimay";"18-19";220;139;359
"4304";"Los Álamos";"18-19";395;388;783
"4305";"Los Andes";"18-19";1338;937;2275
"4306";"Los Ángeles";"18-19";3167;3009;6176
"4307";"Los Lagos";"18-19";408;354;762
"4308";"Los Muermos";"18-19";249;247;496
"4309";"Los Sauces";"18-19";123;114;237
"4310";"Los Vilos";"18-19";360;312;672
"4311";"Lota";"18-19";786;772;1558
"4312";"Lumaco";"18-19";181;153;334
"4313";"Machalí";"18-19";768;753;1521
"4314";"Macul";"18-19";1706;1570;3276
"4315";"Máfil";"18-19";149;115;264
"4316";"Maipú";"18-19";8694;8464;17158
"4317";"Malloa";"18-19";220;249;469
"4318";"Marchihue";"18-19";103;104;207
"4319";"María Elena";"18-19";75;74;149
"4320";"María Pinto";"18-19";190;193;383
"4321";"Mariquina";"18-19";332;298;630
"4322";"Maule";"18-19";742;734;1476
"4323";"Maullín";"18-19";237;202;439
"4324";"Mejillones";"18-19";157;161;318
"4325";"Melipeuco";"18-19";87;78;165
"4326";"Melipilla";"18-19";1928;1727;3655
"4327";"Molina";"18-19";656;691;1347
"4328";"Monte Patria";"18-19";458;496;954
"4329";"Mostazal";"18-19";412;431;843
"4330";"Mulchén";"18-19";480;488;968
"4331";"Nacimiento";"18-19";400;432;832
"4332";"Nancagua";"18-19";292;259;551
"4333";"Natales";"18-19";306;264;570
"4334";"Navidad";"18-19";76;74;150
"4335";"Negrete";"18-19";172;156;328
"4336";"Ninhue";"18-19";85;92;177
"4337";"Nogales";"18-19";382;354;736
"4338";"Nueva Imperial";"18-19";670;590;1260
"4339";"Ñiquén";"18-19";173;166;339
"4340";"Ñuñoa";"18-19";2612;2488;5100
"4341";"O´Higgins";"18-19";9;1;10
"4342";"Olivar";"18-19";257;236;493
"4343";"Ollagüe";"18-19";2;2;4
"4344";"Olmué";"18-19";255;226;481
"4345";"Osorno";"18-19";2962;2563;5525
"4346";"Ovalle";"18-19";1924;2006;3930
"4347";"Padre Hurtado";"18-19";760;760;1520
"4348";"Padre Las Casas";"18-19";1517;1410;2927
"4349";"Paiguano";"18-19";41;50;91
"4350";"Paillaco";"18-19";338;324;662
"4351";"Paine";"18-19";1085;927;2012
"4352";"Palena";"18-19";14;9;23
"4353";"Palmilla";"18-19";212;212;424
"4354";"Panguipulli";"18-19";658;653;1311
"4355";"Panquehue";"18-19";98;112;210
"4356";"Papudo";"18-19";88;75;163
"4357";"Paredones";"18-19";93;80;173
"4358";"Parral";"18-19";661;566;1227
"4359";"Pedro Aguirre Cerda";"18-19";1783;1700;3483
"4360";"Pelarco";"18-19";136;120;256
"4361";"Pelluhue";"18-19";114;110;224
"4362";"Pemuco";"18-19";172;140;312
"4363";"Pencahue";"18-19";114;117;231
"4364";"Penco";"18-19";820;815;1635
"4365";"Peñaflor";"18-19";1227;1208;2435
"4366";"Peñalolen";"18-19";3570;3540;7110
"4367";"Peralillo";"18-19";174;185;359
"4368";"Perquenco";"18-19";112;125;237
"4369";"Petorca";"18-19";154;133;287
"4370";"Peumo";"18-19";241;228;469
"4371";"Pica";"18-19";58;52;110
"4372";"Pichidegua";"18-19";302;314;616
"4373";"Pichilemu";"18-19";200;220;420
"4374";"Pinto";"18-19";185;173;358
"4375";"Pirque";"18-19";339;300;639
"4376";"Pitrufquén";"18-19";374;371;745
"4377";"Placilla";"18-19";150;148;298
"4378";"Portezuelo";"18-19";90;88;178
"4379";"Porvenir";"18-19";210;91;301
"4380";"Pozo Almonte";"18-19";411;172;583
"4381";"Primavera";"18-19";2;2;4
"4382";"Providencia";"18-19";1477;1494;2971
"4383";"Puchuncaví";"18-19";243;224;467
"4384";"Pucón";"18-19";432;397;829
"4385";"Pudahuel";"18-19";3627;3591;7218
"4386";"Puente Alto";"18-19";9682;9451;19133
"4387";"Puerto Montt";"18-19";3859;3962;7821
"4388";"Puerto Octay";"18-19";136;140;276
"4389";"Puerto Varas";"18-19";805;597;1402
"4390";"Pumanque";"18-19";54;48;102
"4391";"Punitaqui";"18-19";163;168;331
"4392";"Punta Arenas";"18-19";1832;1901;3733
"4393";"Puqueldón";"18-19";51;50;101
"4394";"Purén";"18-19";207;188;395
"4395";"Purranque";"18-19";326;323;649
"4396";"Putaendo";"18-19";219;234;453
"4397";"Putre";"18-19";116;14;130
"4398";"Puyehue";"18-19";224;170;394
"4399";"Queilén";"18-19";73;52;125
"4400";"Quellón";"18-19";487;463;950
"4401";"Quemchi";"18-19";98;93;191
"4402";"Quilaco";"18-19";69;55;124
"4403";"Quilicura";"18-19";3067;3005;6072
"4404";"Quilleco";"18-19";128;145;273
"4405";"Quillón";"18-19";247;222;469
"4406";"Quillota";"18-19";1582;1459;3041
"4407";"Quilpué";"18-19";2393;2294;4687
"4408";"Quinchao";"18-19";154;155;309
"4409";"Quinta de  Tilcoco";"18-19";216;225;441
"4410";"Quinta Normal";"18-19";1506;1425;2931
"4411";"Quintero";"18-19";377;392;769
"4412";"Quirihue";"18-19";210;210;420
"4413";"Rancagua";"18-19";3729;3648;7377
"4414";"Ránquil";"18-19";85;79;164
"4415";"Rauco";"18-19";148;139;287
"4416";"Recoleta";"18-19";2554;2193;4747
"4417";"Renaico";"18-19";208;182;390
"4418";"Renca";"18-19";2348;2250;4598
"4419";"Rengo";"18-19";964;982;1946
"4420";"Requínoa";"18-19";511;472;983
"4421";"Retiro";"18-19";328;326;654
"4422";"Rinconada";"18-19";140;139;279
"4423";"Río Bueno";"18-19";432;478;910
"4424";"Río Claro";"18-19";214;210;424
"4425";"Río Hurtado";"18-19";90;60;150
"4426";"Río Ibáñez";"18-19";10;14;24
"4427";"Río Negro";"18-19";230;199;429
"4428";"Río Verde";"18-19";1;0;1
"4429";"Romeral";"18-19";265;233;498
"4430";"Saavedra";"18-19";246;197;443
"4431";"Sagrada Familia";"18-19";322;293;615
"4432";"Salamanca";"18-19";336;392;728
"4433";"San Antonio";"18-19";1507;1450;2957
"4434";"San Bernardo";"18-19";4879;4576;9455
"4435";"San Carlos";"18-19";849;824;1673
"4436";"San Clemente";"18-19";627;624;1251
"4437";"San Esteban";"18-19";260;252;512
"4438";"San Fabián";"18-19";64;65;129
"4439";"San Felipe";"18-19";1068;1093;2161
"4440";"San Fernando";"18-19";1368;1300;2668
"4441";"San Gregorio";"18-19";0;0;0
"4442";"San Ignacio";"18-19";256;256;512
"4443";"San Javier";"18-19";649;625;1274
"4444";"San Joaquín";"18-19";1440;1358;2798
"4445";"San José  de Maipo";"18-19";300;198;498
"4446";"San Juan de la Costa";"18-19";103;77;180
"4447";"San Miguel";"18-19";1354;1293;2647
"4448";"San Nicolás";"18-19";169;168;337
"4449";"San Pablo";"18-19";143;158;301
"4450";"San Pedro";"18-19";141;116;257
"4451";"San Pedro de  la Paz";"18-19";2096;2076;4172
"4452";"San Pedro de Atacama";"18-19";199;72;271
"4453";"San Rafael";"18-19";139;144;283
"4454";"San Ramón";"18-19";1380;1364;2744
"4455";"San Rosendo";"18-19";67;72;139
"4456";"San Vicente";"18-19";723;706;1429
"4457";"Santa Bárbara";"18-19";218;202;420
"4458";"Santa Cruz";"18-19";641;580;1221
"4459";"Santa Juana";"18-19";193;209;402
"4460";"Santa María";"18-19";236;230;466
"4461";"Santiago";"18-19";3738;3295;7033
"4462";"Santo Domingo";"18-19";126;125;251
"4463";"Sierra Gorda";"18-19";22;14;36
"4464";"Talagante";"18-19";1138;1128;2266
"4465";"Talca";"18-19";4074;3907;7981
"4466";"Talcahuano";"18-19";3344;2828;6172
"4467";"Taltal";"18-19";172;187;359
"4468";"Temuco";"18-19";4765;5061;9826
"4469";"Teno";"18-19";468;470;938
"4470";"Teodoro Schmidt";"18-19";244;209;453
"4471";"Tierra Amarilla";"18-19";244;248;492
"4472";"Tiltil";"18-19";265;248;513
"4473";"Timaukel";"18-19";1;0;1
"4474";"Tirúa";"18-19";161;159;320
"4475";"Tocopilla";"18-19";427;404;831
"4476";"Toltén";"18-19";169;150;319
"4477";"Tomé";"18-19";919;890;1809
"4478";"Torres del Paine";"18-19";1;3;4
"4479";"Tortel";"18-19";23;8;31
"4480";"Traiguén";"18-19";432;297;729
"4481";"Treguaco";"18-19";60;76;136
"4482";"Tucapel";"18-19";220;199;419
"4483";"Valdivia";"18-19";2924;2816;5740
"4484";"Vallenar";"18-19";817;856;1673
"4485";"Valparaíso";"18-19";4714;4322;9036
"4486";"Vichuquén";"18-19";68;60;128
"4487";"Victoria";"18-19";666;554;1220
"4488";"Vicuña";"18-19";397;378;775
"4489";"Vilcún";"18-19";449;426;875
"4490";"Villa Alegre";"18-19";266;262;528
"4491";"Villa Alemana";"18-19";1969;1936;3905
"4492";"Villarrica";"18-19";881;862;1743
"4493";"Viña del Mar";"18-19";5156;4980;10136
"4494";"Vitacura";"18-19";1154;1198;2352
"4495";"Yerbas Buenas";"18-19";350;320;670
"4496";"Yumbel";"18-19";321;294;615
"4497";"Yungay";"18-19";265;232;497
"4498";"Zapallar";"18-19";85;76;161
