"";"comuna_name";"edad";"hombres";"mujeres";"total"
"1";"arica";"20 a 24";9391;8652;18043
"2";"arica";"25 a 29";9377;8797;18174
"3";"arica";"30 a 34";8192;8306;16498
"4";"arica";"35 a 39";7343;7707;15050
"5";"arica";"40 a 44";7143;7607;14750
"6";"arica";"45 a 49";6596;7224;13820
"7";"arica";"50 a 54";6201;7122;13323
"8";"arica";"55 a 59";5481;6176;11657
"9";"arica";"60 a 64";5035;5138;10173
"10";"arica";"65 a 69";3770;4310;8080
"11";"arica";"70 a 74";3033;3502;6535
"12";"arica";"75 a 79";1904;2356;4260
"13";"arica";"80 a 84";1108;1629;2737
"14";"arica";"85 a 89";619;999;1618
"15";"arica";"90 a 94";208;396;604
"16";"arica";"95 a 99";34;119;153
"17";"arica";"100 o más";10;40;50
"18";"camarones";"20 a 24";46;26;72
"19";"camarones";"25 a 29";65;39;104
"20";"camarones";"30 a 34";52;41;93
"21";"camarones";"35 a 39";51;33;84
"22";"camarones";"40 a 44";59;30;89
"23";"camarones";"45 a 49";48;34;82
"24";"camarones";"50 a 54";56;40;96
"25";"camarones";"55 a 59";57;41;98
"26";"camarones";"60 a 64";54;34;88
"27";"camarones";"65 a 69";39;42;81
"28";"camarones";"70 a 74";28;27;55
"29";"camarones";"75 a 79";20;11;31
"30";"camarones";"80 a 84";10;8;18
"31";"camarones";"85 a 89";5;7;12
"32";"camarones";"90 a 94";2;4;6
"33";"camarones";"95 a 99";0;2;2
"34";"camarones";"100 o más";1;0;1
"35";"putre";"20 a 24";243;52;295
"36";"putre";"25 a 29";191;59;250
"37";"putre";"30 a 34";189;65;254
"38";"putre";"35 a 39";189;54;243
"39";"putre";"40 a 44";164;57;221
"40";"putre";"45 a 49";126;45;171
"41";"putre";"50 a 54";95;38;133
"42";"putre";"55 a 59";91;39;130
"43";"putre";"60 a 64";54;37;91
"44";"putre";"65 a 69";35;29;64
"45";"putre";"70 a 74";29;28;57
"46";"putre";"75 a 79";26;28;54
"47";"putre";"80 a 84";15;17;32
"48";"putre";"85 a 89";9;12;21
"49";"putre";"90 a 94";1;3;4
"50";"putre";"95 a 99";1;1;2
"51";"putre";"100 o más";0;1;1
"52";"general lagos";"20 a 24";48;10;58
"53";"general lagos";"25 a 29";48;12;60
"54";"general lagos";"30 a 34";36;14;50
"55";"general lagos";"35 a 39";33;22;55
"56";"general lagos";"40 a 44";24;25;49
"57";"general lagos";"45 a 49";27;12;39
"58";"general lagos";"50 a 54";17;24;41
"59";"general lagos";"55 a 59";24;21;45
"60";"general lagos";"60 a 64";25;19;44
"61";"general lagos";"65 a 69";19;15;34
"62";"general lagos";"70 a 74";16;17;33
"63";"general lagos";"75 a 79";11;4;15
"64";"general lagos";"80 a 84";4;6;10
"65";"general lagos";"85 a 89";3;3;6
"66";"general lagos";"90 a 94";1;0;1
"67";"general lagos";"95 a 99";0;0;0
"68";"general lagos";"100 o más";0;0;0
"69";"iquique";"20 a 24";7574;7444;15018
"70";"iquique";"25 a 29";8896;8745;17641
"71";"iquique";"30 a 34";8180;8237;16417
"72";"iquique";"35 a 39";7393;7644;15037
"73";"iquique";"40 a 44";6586;6717;13303
"74";"iquique";"45 a 49";5696;5919;11615
"75";"iquique";"50 a 54";5591;5887;11478
"76";"iquique";"55 a 59";5052;5488;10540
"77";"iquique";"60 a 64";4613;4690;9303
"78";"iquique";"65 a 69";3089;3373;6462
"79";"iquique";"70 a 74";2208;2343;4551
"80";"iquique";"75 a 79";1236;1648;2884
"81";"iquique";"80 a 84";744;1155;1899
"82";"iquique";"85 a 89";439;803;1242
"83";"iquique";"90 a 94";161;377;538
"84";"iquique";"95 a 99";31;93;124
"85";"iquique";"100 o más";15;15;30
"86";"alto hospicio";"20 a 24";5050;4857;9907
"87";"alto hospicio";"25 a 29";5005;4999;10004
"88";"alto hospicio";"30 a 34";4284;4320;8604
"89";"alto hospicio";"35 a 39";3801;3994;7795
"90";"alto hospicio";"40 a 44";3369;3607;6976
"91";"alto hospicio";"45 a 49";3087;3366;6453
"92";"alto hospicio";"50 a 54";3015;3004;6019
"93";"alto hospicio";"55 a 59";2253;2240;4493
"94";"alto hospicio";"60 a 64";1655;1565;3220
"95";"alto hospicio";"65 a 69";1003;1000;2003
"96";"alto hospicio";"70 a 74";589;685;1274
"97";"alto hospicio";"75 a 79";277;376;653
"98";"alto hospicio";"80 a 84";145;228;373
"99";"alto hospicio";"85 a 89";76;131;207
"100";"alto hospicio";"90 a 94";25;45;70
"101";"alto hospicio";"95 a 99";8;13;21
"102";"alto hospicio";"100 o más";9;6;15
"103";"pozo almonte";"20 a 24";764;466;1230
"104";"pozo almonte";"25 a 29";800;568;1368
"105";"pozo almonte";"30 a 34";819;585;1404
"106";"pozo almonte";"35 a 39";749;497;1246
"107";"pozo almonte";"40 a 44";705;439;1144
"108";"pozo almonte";"45 a 49";544;346;890
"109";"pozo almonte";"50 a 54";536;314;850
"110";"pozo almonte";"55 a 59";462;327;789
"111";"pozo almonte";"60 a 64";366;284;650
"112";"pozo almonte";"65 a 69";220;161;381
"113";"pozo almonte";"70 a 74";190;133;323
"114";"pozo almonte";"75 a 79";99;100;199
"115";"pozo almonte";"80 a 84";65;74;139
"116";"pozo almonte";"85 a 89";26;32;58
"117";"pozo almonte";"90 a 94";8;15;23
"118";"pozo almonte";"95 a 99";1;4;5
"119";"pozo almonte";"100 o más";1;1;2
"120";"camiña";"20 a 24";42;40;82
"121";"camiña";"25 a 29";44;41;85
"122";"camiña";"30 a 34";41;30;71
"123";"camiña";"35 a 39";25;38;63
"124";"camiña";"40 a 44";55;35;90
"125";"camiña";"45 a 49";44;39;83
"126";"camiña";"50 a 54";45;37;82
"127";"camiña";"55 a 59";40;31;71
"128";"camiña";"60 a 64";34;27;61
"129";"camiña";"65 a 69";27;25;52
"130";"camiña";"70 a 74";28;22;50
"131";"camiña";"75 a 79";21;21;42
"132";"camiña";"80 a 84";16;12;28
"133";"camiña";"85 a 89";10;3;13
"134";"camiña";"90 a 94";3;4;7
"135";"camiña";"95 a 99";2;1;3
"136";"camiña";"100 o más";1;0;1
"137";"colchane";"20 a 24";98;61;159
"138";"colchane";"25 a 29";122;71;193
"139";"colchane";"30 a 34";98;49;147
"140";"colchane";"35 a 39";83;60;143
"141";"colchane";"40 a 44";77;44;121
"142";"colchane";"45 a 49";58;48;106
"143";"colchane";"50 a 54";48;56;104
"144";"colchane";"55 a 59";43;45;88
"145";"colchane";"60 a 64";59;35;94
"146";"colchane";"65 a 69";39;38;77
"147";"colchane";"70 a 74";29;26;55
"148";"colchane";"75 a 79";27;15;42
"149";"colchane";"80 a 84";9;10;19
"150";"colchane";"85 a 89";5;4;9
"151";"colchane";"90 a 94";2;3;5
"152";"colchane";"95 a 99";1;1;2
"153";"colchane";"100 o más";0;0;0
"154";"huara";"20 a 24";98;78;176
"155";"huara";"25 a 29";113;101;214
"156";"huara";"30 a 34";107;87;194
"157";"huara";"35 a 39";103;71;174
"158";"huara";"40 a 44";85;64;149
"159";"huara";"45 a 49";108;68;176
"160";"huara";"50 a 54";100;84;184
"161";"huara";"55 a 59";100;55;155
"162";"huara";"60 a 64";74;79;153
"163";"huara";"65 a 69";77;59;136
"164";"huara";"70 a 74";52;48;100
"165";"huara";"75 a 79";44;26;70
"166";"huara";"80 a 84";20;16;36
"167";"huara";"85 a 89";12;16;28
"168";"huara";"90 a 94";6;6;12
"169";"huara";"95 a 99";1;3;4
"170";"huara";"100 o más";1;0;1
"171";"pica";"20 a 24";291;175;466
"172";"pica";"25 a 29";740;285;1025
"173";"pica";"30 a 34";902;228;1130
"174";"pica";"35 a 39";907;198;1105
"175";"pica";"40 a 44";827;176;1003
"176";"pica";"45 a 49";728;185;913
"177";"pica";"50 a 54";517;134;651
"178";"pica";"55 a 59";324;151;475
"179";"pica";"60 a 64";208;121;329
"180";"pica";"65 a 69";115;122;237
"181";"pica";"70 a 74";91;83;174
"182";"pica";"75 a 79";58;74;132
"183";"pica";"80 a 84";27;46;73
"184";"pica";"85 a 89";21;33;54
"185";"pica";"90 a 94";11;10;21
"186";"pica";"95 a 99";3;6;9
"187";"pica";"100 o más";0;3;3
"188";"antofagasta";"20 a 24";17015;16068;33083
"189";"antofagasta";"25 a 29";17765;16367;34132
"190";"antofagasta";"30 a 34";15352;14280;29632
"191";"antofagasta";"35 a 39";14031;13612;27643
"192";"antofagasta";"40 a 44";13618;13209;26827
"193";"antofagasta";"45 a 49";11862;11514;23376
"194";"antofagasta";"50 a 54";10745;10633;21378
"195";"antofagasta";"55 a 59";9311;9612;18923
"196";"antofagasta";"60 a 64";7235;7619;14854
"197";"antofagasta";"65 a 69";4768;5456;10224
"198";"antofagasta";"70 a 74";3192;4099;7291
"199";"antofagasta";"75 a 79";1966;3002;4968
"200";"antofagasta";"80 a 84";1131;1978;3109
"201";"antofagasta";"85 a 89";593;1382;1975
"202";"antofagasta";"90 a 94";196;519;715
"203";"antofagasta";"95 a 99";30;145;175
"204";"antofagasta";"100 o más";32;46;78
"205";"mejillones";"20 a 24";613;484;1097
"206";"mejillones";"25 a 29";884;548;1432
"207";"mejillones";"30 a 34";781;443;1224
"208";"mejillones";"35 a 39";705;414;1119
"209";"mejillones";"40 a 44";721;354;1075
"210";"mejillones";"45 a 49";701;320;1021
"211";"mejillones";"50 a 54";672;338;1010
"212";"mejillones";"55 a 59";491;276;767
"213";"mejillones";"60 a 64";325;208;533
"214";"mejillones";"65 a 69";183;132;315
"215";"mejillones";"70 a 74";97;97;194
"216";"mejillones";"75 a 79";64;76;140
"217";"mejillones";"80 a 84";24;32;56
"218";"mejillones";"85 a 89";14;18;32
"219";"mejillones";"90 a 94";7;10;17
"220";"mejillones";"95 a 99";1;2;3
"221";"mejillones";"100 o más";0;1;1
"222";"sierra gorda";"20 a 24";447;135;582
"223";"sierra gorda";"25 a 29";1161;259;1420
"224";"sierra gorda";"30 a 34";1407;228;1635
"225";"sierra gorda";"35 a 39";1405;186;1591
"226";"sierra gorda";"40 a 44";1394;172;1566
"227";"sierra gorda";"45 a 49";1090;131;1221
"228";"sierra gorda";"50 a 54";770;91;861
"229";"sierra gorda";"55 a 59";448;55;503
"230";"sierra gorda";"60 a 64";214;37;251
"231";"sierra gorda";"65 a 69";58;17;75
"232";"sierra gorda";"70 a 74";16;7;23
"233";"sierra gorda";"75 a 79";9;5;14
"234";"sierra gorda";"80 a 84";4;3;7
"235";"sierra gorda";"85 a 89";2;3;5
"236";"sierra gorda";"90 a 94";1;1;2
"237";"sierra gorda";"95 a 99";0;0;0
"238";"sierra gorda";"100 o más";0;0;0
"239";"taltal";"20 a 24";464;370;834
"240";"taltal";"25 a 29";674;462;1136
"241";"taltal";"30 a 34";620;427;1047
"242";"taltal";"35 a 39";617;455;1072
"243";"taltal";"40 a 44";618;394;1012
"244";"taltal";"45 a 49";589;375;964
"245";"taltal";"50 a 54";566;370;936
"246";"taltal";"55 a 59";470;352;822
"247";"taltal";"60 a 64";385;270;655
"248";"taltal";"65 a 69";226;188;414
"249";"taltal";"70 a 74";167;150;317
"250";"taltal";"75 a 79";107;93;200
"251";"taltal";"80 a 84";66;82;148
"252";"taltal";"85 a 89";28;63;91
"253";"taltal";"90 a 94";11;22;33
"254";"taltal";"95 a 99";2;5;7
"255";"taltal";"100 o más";1;1;2
"256";"calama";"20 a 24";6596;6008;12604
"257";"calama";"25 a 29";8034;7224;15258
"258";"calama";"30 a 34";7548;6856;14404
"259";"calama";"35 a 39";7371;6357;13728
"260";"calama";"40 a 44";6796;6024;12820
"261";"calama";"45 a 49";5891;5161;11052
"262";"calama";"50 a 54";5622;4984;10606
"263";"calama";"55 a 59";4613;4175;8788
"264";"calama";"60 a 64";3409;3136;6545
"265";"calama";"65 a 69";2124;2142;4266
"266";"calama";"70 a 74";1410;1596;3006
"267";"calama";"75 a 79";740;994;1734
"268";"calama";"80 a 84";453;679;1132
"269";"calama";"85 a 89";230;399;629
"270";"calama";"90 a 94";79;173;252
"271";"calama";"95 a 99";20;41;61
"272";"calama";"100 o más";11;16;27
"273";"ollagüe";"20 a 24";12;5;17
"274";"ollagüe";"25 a 29";26;13;39
"275";"ollagüe";"30 a 34";18;13;31
"276";"ollagüe";"35 a 39";28;11;39
"277";"ollagüe";"40 a 44";20;9;29
"278";"ollagüe";"45 a 49";21;6;27
"279";"ollagüe";"50 a 54";16;3;19
"280";"ollagüe";"55 a 59";10;5;15
"281";"ollagüe";"60 a 64";7;4;11
"282";"ollagüe";"65 a 69";2;4;6
"283";"ollagüe";"70 a 74";2;8;10
"284";"ollagüe";"75 a 79";1;2;3
"285";"ollagüe";"80 a 84";2;1;3
"286";"ollagüe";"85 a 89";1;1;2
"287";"ollagüe";"90 a 94";0;0;0
"288";"ollagüe";"95 a 99";0;0;0
"289";"ollagüe";"100 o más";0;0;0
"290";"san pedro de atacama";"20 a 24";426;388;814
"291";"san pedro de atacama";"25 a 29";792;676;1468
"292";"san pedro de atacama";"30 a 34";724;545;1269
"293";"san pedro de atacama";"35 a 39";735;454;1189
"294";"san pedro de atacama";"40 a 44";617;342;959
"295";"san pedro de atacama";"45 a 49";492;271;763
"296";"san pedro de atacama";"50 a 54";380;260;640
"297";"san pedro de atacama";"55 a 59";311;196;507
"298";"san pedro de atacama";"60 a 64";229;174;403
"299";"san pedro de atacama";"65 a 69";122;112;234
"300";"san pedro de atacama";"70 a 74";73;105;178
"301";"san pedro de atacama";"75 a 79";60;79;139
"302";"san pedro de atacama";"80 a 84";38;44;82
"303";"san pedro de atacama";"85 a 89";19;29;48
"304";"san pedro de atacama";"90 a 94";4;12;16
"305";"san pedro de atacama";"95 a 99";4;5;9
"306";"san pedro de atacama";"100 o más";0;1;1
"307";"tocopilla";"20 a 24";824;802;1626
"308";"tocopilla";"25 a 29";974;1103;2077
"309";"tocopilla";"30 a 34";909;938;1847
"310";"tocopilla";"35 a 39";802;812;1614
"311";"tocopilla";"40 a 44";785;798;1583
"312";"tocopilla";"45 a 49";784;781;1565
"313";"tocopilla";"50 a 54";786;765;1551
"314";"tocopilla";"55 a 59";802;753;1555
"315";"tocopilla";"60 a 64";658;642;1300
"316";"tocopilla";"65 a 69";475;478;953
"317";"tocopilla";"70 a 74";316;372;688
"318";"tocopilla";"75 a 79";198;256;454
"319";"tocopilla";"80 a 84";109;184;293
"320";"tocopilla";"85 a 89";60;152;212
"321";"tocopilla";"90 a 94";15;38;53
"322";"tocopilla";"95 a 99";6;8;14
"323";"tocopilla";"100 o más";4;3;7
"324";"maría elena";"20 a 24";247;187;434
"325";"maría elena";"25 a 29";431;228;659
"326";"maría elena";"30 a 34";475;219;694
"327";"maría elena";"35 a 39";458;164;622
"328";"maría elena";"40 a 44";437;192;629
"329";"maría elena";"45 a 49";385;163;548
"330";"maría elena";"50 a 54";383;184;567
"331";"maría elena";"55 a 59";264;135;399
"332";"maría elena";"60 a 64";186;97;283
"333";"maría elena";"65 a 69";98;58;156
"334";"maría elena";"70 a 74";34;31;65
"335";"maría elena";"75 a 79";20;21;41
"336";"maría elena";"80 a 84";10;9;19
"337";"maría elena";"85 a 89";4;9;13
"338";"maría elena";"90 a 94";0;2;2
"339";"maría elena";"95 a 99";0;1;1
"340";"maría elena";"100 o más";0;1;1
"341";"copiapó";"20 a 24";6475;6216;12691
"342";"copiapó";"25 a 29";6785;6619;13404
"343";"copiapó";"30 a 34";5819;5765;11584
"344";"copiapó";"35 a 39";5318;5350;10668
"345";"copiapó";"40 a 44";4968;5096;10064
"346";"copiapó";"45 a 49";4938;5050;9988
"347";"copiapó";"50 a 54";4788;4950;9738
"348";"copiapó";"55 a 59";4139;4366;8505
"349";"copiapó";"60 a 64";3256;3348;6604
"350";"copiapó";"65 a 69";2215;2475;4690
"351";"copiapó";"70 a 74";1559;1835;3394
"352";"copiapó";"75 a 79";1097;1377;2474
"353";"copiapó";"80 a 84";680;962;1642
"354";"copiapó";"85 a 89";354;603;957
"355";"copiapó";"90 a 94";102;225;327
"356";"copiapó";"95 a 99";21;53;74
"357";"copiapó";"100 o más";12;18;30
"358";"caldera";"20 a 24";670;600;1270
"359";"caldera";"25 a 29";686;715;1401
"360";"caldera";"30 a 34";655;605;1260
"361";"caldera";"35 a 39";617;563;1180
"362";"caldera";"40 a 44";586;541;1127
"363";"caldera";"45 a 49";551;514;1065
"364";"caldera";"50 a 54";667;571;1238
"365";"caldera";"55 a 59";609;552;1161
"366";"caldera";"60 a 64";507;438;945
"367";"caldera";"65 a 69";330;324;654
"368";"caldera";"70 a 74";224;232;456
"369";"caldera";"75 a 79";146;155;301
"370";"caldera";"80 a 84";102;101;203
"371";"caldera";"85 a 89";46;67;113
"372";"caldera";"90 a 94";9;18;27
"373";"caldera";"95 a 99";3;11;14
"374";"caldera";"100 o más";2;2;4
"375";"tierra amarilla";"20 a 24";607;490;1097
"376";"tierra amarilla";"25 a 29";687;548;1235
"377";"tierra amarilla";"30 a 34";590;460;1050
"378";"tierra amarilla";"35 a 39";616;417;1033
"379";"tierra amarilla";"40 a 44";641;387;1028
"380";"tierra amarilla";"45 a 49";587;394;981
"381";"tierra amarilla";"50 a 54";587;413;1000
"382";"tierra amarilla";"55 a 59";463;337;800
"383";"tierra amarilla";"60 a 64";332;253;585
"384";"tierra amarilla";"65 a 69";208;178;386
"385";"tierra amarilla";"70 a 74";147;127;274
"386";"tierra amarilla";"75 a 79";92;89;181
"387";"tierra amarilla";"80 a 84";70;73;143
"388";"tierra amarilla";"85 a 89";27;36;63
"389";"tierra amarilla";"90 a 94";3;11;14
"390";"tierra amarilla";"95 a 99";1;2;3
"391";"tierra amarilla";"100 o más";3;1;4
"392";"chañaral";"20 a 24";445;394;839
"393";"chañaral";"25 a 29";531;468;999
"394";"chañaral";"30 a 34";452;389;841
"395";"chañaral";"35 a 39";407;384;791
"396";"chañaral";"40 a 44";388;389;777
"397";"chañaral";"45 a 49";390;338;728
"398";"chañaral";"50 a 54";389;404;793
"399";"chañaral";"55 a 59";377;378;755
"400";"chañaral";"60 a 64";299;279;578
"401";"chañaral";"65 a 69";211;220;431
"402";"chañaral";"70 a 74";165;183;348
"403";"chañaral";"75 a 79";118;155;273
"404";"chañaral";"80 a 84";77;82;159
"405";"chañaral";"85 a 89";33;56;89
"406";"chañaral";"90 a 94";11;21;32
"407";"chañaral";"95 a 99";3;7;10
"408";"chañaral";"100 o más";3;1;4
"409";"diego de almagro";"20 a 24";405;362;767
"410";"diego de almagro";"25 a 29";566;511;1077
"411";"diego de almagro";"30 a 34";600;532;1132
"412";"diego de almagro";"35 a 39";641;519;1160
"413";"diego de almagro";"40 a 44";617;489;1106
"414";"diego de almagro";"45 a 49";595;430;1025
"415";"diego de almagro";"50 a 54";512;439;951
"416";"diego de almagro";"55 a 59";475;419;894
"417";"diego de almagro";"60 a 64";384;255;639
"418";"diego de almagro";"65 a 69";225;169;394
"419";"diego de almagro";"70 a 74";124;119;243
"420";"diego de almagro";"75 a 79";90;97;187
"421";"diego de almagro";"80 a 84";43;44;87
"422";"diego de almagro";"85 a 89";35;32;67
"423";"diego de almagro";"90 a 94";5;9;14
"424";"diego de almagro";"95 a 99";1;3;4
"425";"diego de almagro";"100 o más";2;2;4
"426";"vallenar";"20 a 24";1692;1658;3350
"427";"vallenar";"25 a 29";2022;2026;4048
"428";"vallenar";"30 a 34";1785;1928;3713
"429";"vallenar";"35 a 39";1627;1673;3300
"430";"vallenar";"40 a 44";1524;1660;3184
"431";"vallenar";"45 a 49";1633;1778;3411
"432";"vallenar";"50 a 54";1770;1903;3673
"433";"vallenar";"55 a 59";1440;1603;3043
"434";"vallenar";"60 a 64";1267;1320;2587
"435";"vallenar";"65 a 69";926;1095;2021
"436";"vallenar";"70 a 74";763;831;1594
"437";"vallenar";"75 a 79";550;656;1206
"438";"vallenar";"80 a 84";362;474;836
"439";"vallenar";"85 a 89";181;277;458
"440";"vallenar";"90 a 94";59;132;191
"441";"vallenar";"95 a 99";14;41;55
"442";"vallenar";"100 o más";3;7;10
"443";"alto del carmen";"20 a 24";145;140;285
"444";"alto del carmen";"25 a 29";195;192;387
"445";"alto del carmen";"30 a 34";221;149;370
"446";"alto del carmen";"35 a 39";206;144;350
"447";"alto del carmen";"40 a 44";225;135;360
"448";"alto del carmen";"45 a 49";232;158;390
"449";"alto del carmen";"50 a 54";223;166;389
"450";"alto del carmen";"55 a 59";184;147;331
"451";"alto del carmen";"60 a 64";160;137;297
"452";"alto del carmen";"65 a 69";158;96;254
"453";"alto del carmen";"70 a 74";117;103;220
"454";"alto del carmen";"75 a 79";90;76;166
"455";"alto del carmen";"80 a 84";55;57;112
"456";"alto del carmen";"85 a 89";34;38;72
"457";"alto del carmen";"90 a 94";16;13;29
"458";"alto del carmen";"95 a 99";5;3;8
"459";"alto del carmen";"100 o más";3;1;4
"460";"freirina";"20 a 24";233;235;468
"461";"freirina";"25 a 29";282;268;550
"462";"freirina";"30 a 34";236;235;471
"463";"freirina";"35 a 39";213;203;416
"464";"freirina";"40 a 44";209;207;416
"465";"freirina";"45 a 49";224;242;466
"466";"freirina";"50 a 54";286;251;537
"467";"freirina";"55 a 59";231;213;444
"468";"freirina";"60 a 64";173;171;344
"469";"freirina";"65 a 69";137;142;279
"470";"freirina";"70 a 74";116;110;226
"471";"freirina";"75 a 79";92;84;176
"472";"freirina";"80 a 84";45;53;98
"473";"freirina";"85 a 89";28;36;64
"474";"freirina";"90 a 94";16;24;40
"475";"freirina";"95 a 99";2;7;9
"476";"freirina";"100 o más";0;0;0
"477";"huasco";"20 a 24";299;291;590
"478";"huasco";"25 a 29";438;412;850
"479";"huasco";"30 a 34";388;353;741
"480";"huasco";"35 a 39";349;319;668
"481";"huasco";"40 a 44";333;249;582
"482";"huasco";"45 a 49";324;326;650
"483";"huasco";"50 a 54";399;349;748
"484";"huasco";"55 a 59";360;318;678
"485";"huasco";"60 a 64";306;306;612
"486";"huasco";"65 a 69";204;218;422
"487";"huasco";"70 a 74";160;130;290
"488";"huasco";"75 a 79";107;115;222
"489";"huasco";"80 a 84";60;86;146
"490";"huasco";"85 a 89";29;61;90
"491";"huasco";"90 a 94";7;20;27
"492";"huasco";"95 a 99";3;6;9
"493";"huasco";"100 o más";1;1;2
"494";"la serena";"20 a 24";9846;9820;19666
"495";"la serena";"25 a 29";9034;9115;18149
"496";"la serena";"30 a 34";7383;7788;15171
"497";"la serena";"35 a 39";6636;7637;14273
"498";"la serena";"40 a 44";6710;7832;14542
"499";"la serena";"45 a 49";6451;7649;14100
"500";"la serena";"50 a 54";6365;7485;13850
"501";"la serena";"55 a 59";5553;6737;12290
"502";"la serena";"60 a 64";4579;5602;10181
"503";"la serena";"65 a 69";3501;4380;7881
"504";"la serena";"70 a 74";2715;3481;6196
"505";"la serena";"75 a 79";1847;2529;4376
"506";"la serena";"80 a 84";1224;1794;3018
"507";"la serena";"85 a 89";635;1201;1836
"508";"la serena";"90 a 94";199;502;701
"509";"la serena";"95 a 99";65;138;203
"510";"la serena";"100 o más";23;46;69
"511";"coquimbo";"20 a 24";9111;9242;18353
"512";"coquimbo";"25 a 29";9178;9455;18633
"513";"coquimbo";"30 a 34";7855;8430;16285
"514";"coquimbo";"35 a 39";7022;7997;15019
"515";"coquimbo";"40 a 44";7141;7859;15000
"516";"coquimbo";"45 a 49";6899;7688;14587
"517";"coquimbo";"50 a 54";6633;7703;14336
"518";"coquimbo";"55 a 59";5850;6781;12631
"519";"coquimbo";"60 a 64";5033;5782;10815
"520";"coquimbo";"65 a 69";3774;4305;8079
"521";"coquimbo";"70 a 74";2919;3342;6261
"522";"coquimbo";"75 a 79";1849;2426;4275
"523";"coquimbo";"80 a 84";1121;1678;2799
"524";"coquimbo";"85 a 89";644;1150;1794
"525";"coquimbo";"90 a 94";231;429;660
"526";"coquimbo";"95 a 99";43;131;174
"527";"coquimbo";"100 o más";13;36;49
"528";"andacollo";"20 a 24";372;373;745
"529";"andacollo";"25 a 29";399;416;815
"530";"andacollo";"30 a 34";334;340;674
"531";"andacollo";"35 a 39";323;297;620
"532";"andacollo";"40 a 44";333;352;685
"533";"andacollo";"45 a 49";354;402;756
"534";"andacollo";"50 a 54";428;391;819
"535";"andacollo";"55 a 59";344;356;700
"536";"andacollo";"60 a 64";293;258;551
"537";"andacollo";"65 a 69";209;251;460
"538";"andacollo";"70 a 74";181;200;381
"539";"andacollo";"75 a 79";146;157;303
"540";"andacollo";"80 a 84";94;112;206
"541";"andacollo";"85 a 89";46;52;98
"542";"andacollo";"90 a 94";15;18;33
"543";"andacollo";"95 a 99";6;10;16
"544";"andacollo";"100 o más";0;4;4
"545";"la higuera";"20 a 24";130;123;253
"546";"la higuera";"25 a 29";130;140;270
"547";"la higuera";"30 a 34";103;128;231
"548";"la higuera";"35 a 39";144;127;271
"549";"la higuera";"40 a 44";149;141;290
"550";"la higuera";"45 a 49";167;114;281
"551";"la higuera";"50 a 54";177;145;322
"552";"la higuera";"55 a 59";161;130;291
"553";"la higuera";"60 a 64";137;105;242
"554";"la higuera";"65 a 69";104;99;203
"555";"la higuera";"70 a 74";100;58;158
"556";"la higuera";"75 a 79";50;44;94
"557";"la higuera";"80 a 84";24;38;62
"558";"la higuera";"85 a 89";21;16;37
"559";"la higuera";"90 a 94";4;6;10
"560";"la higuera";"95 a 99";1;1;2
"561";"la higuera";"100 o más";0;1;1
"562";"paiguano";"20 a 24";126;128;254
"563";"paiguano";"25 a 29";181;181;362
"564";"paiguano";"30 a 34";142;173;315
"565";"paiguano";"35 a 39";133;129;262
"566";"paiguano";"40 a 44";156;138;294
"567";"paiguano";"45 a 49";175;173;348
"568";"paiguano";"50 a 54";150;204;354
"569";"paiguano";"55 a 59";182;138;320
"570";"paiguano";"60 a 64";134;104;238
"571";"paiguano";"65 a 69";101;92;193
"572";"paiguano";"70 a 74";75;87;162
"573";"paiguano";"75 a 79";71;60;131
"574";"paiguano";"80 a 84";30;44;74
"575";"paiguano";"85 a 89";33;36;69
"576";"paiguano";"90 a 94";9;16;25
"577";"paiguano";"95 a 99";1;0;1
"578";"paiguano";"100 o más";0;0;0
"579";"vicuña";"20 a 24";969;936;1905
"580";"vicuña";"25 a 29";1032;1057;2089
"581";"vicuña";"30 a 34";925;952;1877
"582";"vicuña";"35 a 39";817;913;1730
"583";"vicuña";"40 a 44";924;944;1868
"584";"vicuña";"45 a 49";947;959;1906
"585";"vicuña";"50 a 54";960;955;1915
"586";"vicuña";"55 a 59";825;827;1652
"587";"vicuña";"60 a 64";721;660;1381
"588";"vicuña";"65 a 69";493;538;1031
"589";"vicuña";"70 a 74";423;443;866
"590";"vicuña";"75 a 79";297;380;677
"591";"vicuña";"80 a 84";222;237;459
"592";"vicuña";"85 a 89";120;141;261
"593";"vicuña";"90 a 94";36;70;106
"594";"vicuña";"95 a 99";9;17;26
"595";"vicuña";"100 o más";3;3;6
"596";"illapel";"20 a 24";876;822;1698
"597";"illapel";"25 a 29";965;1175;2140
"598";"illapel";"30 a 34";978;1134;2112
"599";"illapel";"35 a 39";880;1054;1934
"600";"illapel";"40 a 44";884;1001;1885
"601";"illapel";"45 a 49";1015;1095;2110
"602";"illapel";"50 a 54";992;1113;2105
"603";"illapel";"55 a 59";1015;1015;2030
"604";"illapel";"60 a 64";761;876;1637
"605";"illapel";"65 a 69";660;757;1417
"606";"illapel";"70 a 74";523;561;1084
"607";"illapel";"75 a 79";337;447;784
"608";"illapel";"80 a 84";240;297;537
"609";"illapel";"85 a 89";104;220;324
"610";"illapel";"90 a 94";31;86;117
"611";"illapel";"95 a 99";10;30;40
"612";"illapel";"100 o más";2;5;7
"613";"canela";"20 a 24";260;213;473
"614";"canela";"25 a 29";280;275;555
"615";"canela";"30 a 34";235;248;483
"616";"canela";"35 a 39";248;280;528
"617";"canela";"40 a 44";284;288;572
"618";"canela";"45 a 49";310;286;596
"619";"canela";"50 a 54";359;354;713
"620";"canela";"55 a 59";328;335;663
"621";"canela";"60 a 64";300;272;572
"622";"canela";"65 a 69";271;243;514
"623";"canela";"70 a 74";192;195;387
"624";"canela";"75 a 79";175;199;374
"625";"canela";"80 a 84";135;146;281
"626";"canela";"85 a 89";90;102;192
"627";"canela";"90 a 94";32;23;55
"628";"canela";"95 a 99";5;8;13
"629";"canela";"100 o más";2;3;5
"630";"los vilos";"20 a 24";763;637;1400
"631";"los vilos";"25 a 29";864;801;1665
"632";"los vilos";"30 a 34";878;748;1626
"633";"los vilos";"35 a 39";702;709;1411
"634";"los vilos";"40 a 44";707;701;1408
"635";"los vilos";"45 a 49";740;634;1374
"636";"los vilos";"50 a 54";791;718;1509
"637";"los vilos";"55 a 59";711;695;1406
"638";"los vilos";"60 a 64";563;538;1101
"639";"los vilos";"65 a 69";438;425;863
"640";"los vilos";"70 a 74";329;377;706
"641";"los vilos";"75 a 79";268;279;547
"642";"los vilos";"80 a 84";174;214;388
"643";"los vilos";"85 a 89";81;107;188
"644";"los vilos";"90 a 94";21;44;65
"645";"los vilos";"95 a 99";9;14;23
"646";"los vilos";"100 o más";2;3;5
"647";"salamanca";"20 a 24";890;772;1662
"648";"salamanca";"25 a 29";1258;1057;2315
"649";"salamanca";"30 a 34";1301;1058;2359
"650";"salamanca";"35 a 39";1222;929;2151
"651";"salamanca";"40 a 44";1253;978;2231
"652";"salamanca";"45 a 49";1256;946;2202
"653";"salamanca";"50 a 54";1160;918;2078
"654";"salamanca";"55 a 59";1000;797;1797
"655";"salamanca";"60 a 64";788;698;1486
"656";"salamanca";"65 a 69";604;574;1178
"657";"salamanca";"70 a 74";467;486;953
"658";"salamanca";"75 a 79";301;364;665
"659";"salamanca";"80 a 84";211;248;459
"660";"salamanca";"85 a 89";112;171;283
"661";"salamanca";"90 a 94";45;58;103
"662";"salamanca";"95 a 99";10;20;30
"663";"salamanca";"100 o más";4;6;10
"664";"ovalle";"20 a 24";3905;3963;7868
"665";"ovalle";"25 a 29";4226;4459;8685
"666";"ovalle";"30 a 34";3617;4123;7740
"667";"ovalle";"35 a 39";3326;3848;7174
"668";"ovalle";"40 a 44";3513;3901;7414
"669";"ovalle";"45 a 49";3296;3729;7025
"670";"ovalle";"50 a 54";3410;3996;7406
"671";"ovalle";"55 a 59";3141;3356;6497
"672";"ovalle";"60 a 64";2536;2777;5313
"673";"ovalle";"65 a 69";1921;2113;4034
"674";"ovalle";"70 a 74";1523;1769;3292
"675";"ovalle";"75 a 79";1129;1341;2470
"676";"ovalle";"80 a 84";757;1063;1820
"677";"ovalle";"85 a 89";487;699;1186
"678";"ovalle";"90 a 94";120;265;385
"679";"ovalle";"95 a 99";45;85;130
"680";"ovalle";"100 o más";15;19;34
"681";"combarbalá";"20 a 24";326;321;647
"682";"combarbalá";"25 a 29";399;376;775
"683";"combarbalá";"30 a 34";378;393;771
"684";"combarbalá";"35 a 39";403;426;829
"685";"combarbalá";"40 a 44";507;449;956
"686";"combarbalá";"45 a 49";506;451;957
"687";"combarbalá";"50 a 54";532;499;1031
"688";"combarbalá";"55 a 59";460;453;913
"689";"combarbalá";"60 a 64";415;400;815
"690";"combarbalá";"65 a 69";326;376;702
"691";"combarbalá";"70 a 74";292;293;585
"692";"combarbalá";"75 a 79";256;293;549
"693";"combarbalá";"80 a 84";147;200;347
"694";"combarbalá";"85 a 89";94;137;231
"695";"combarbalá";"90 a 94";24;54;78
"696";"combarbalá";"95 a 99";8;19;27
"697";"combarbalá";"100 o más";1;1;2
"698";"monte patria";"20 a 24";1019;1035;2054
"699";"monte patria";"25 a 29";1028;1144;2172
"700";"monte patria";"30 a 34";917;1030;1947
"701";"monte patria";"35 a 39";917;1001;1918
"702";"monte patria";"40 a 44";953;1038;1991
"703";"monte patria";"45 a 49";1079;1083;2162
"704";"monte patria";"50 a 54";1092;1062;2154
"705";"monte patria";"55 a 59";932;941;1873
"706";"monte patria";"60 a 64";773;692;1465
"707";"monte patria";"65 a 69";592;571;1163
"708";"monte patria";"70 a 74";520;527;1047
"709";"monte patria";"75 a 79";396;409;805
"710";"monte patria";"80 a 84";245;311;556
"711";"monte patria";"85 a 89";147;196;343
"712";"monte patria";"90 a 94";33;78;111
"713";"monte patria";"95 a 99";13;26;39
"714";"monte patria";"100 o más";4;1;5
"715";"punitaqui";"20 a 24";316;307;623
"716";"punitaqui";"25 a 29";350;397;747
"717";"punitaqui";"30 a 34";348;384;732
"718";"punitaqui";"35 a 39";336;337;673
"719";"punitaqui";"40 a 44";325;388;713
"720";"punitaqui";"45 a 49";344;350;694
"721";"punitaqui";"50 a 54";365;342;707
"722";"punitaqui";"55 a 59";326;327;653
"723";"punitaqui";"60 a 64";298;282;580
"724";"punitaqui";"65 a 69";268;270;538
"725";"punitaqui";"70 a 74";218;187;405
"726";"punitaqui";"75 a 79";163;141;304
"727";"punitaqui";"80 a 84";112;109;221
"728";"punitaqui";"85 a 89";41;65;106
"729";"punitaqui";"90 a 94";18;27;45
"730";"punitaqui";"95 a 99";3;11;14
"731";"punitaqui";"100 o más";1;2;3
"732";"río hurtado";"20 a 24";117;108;225
"733";"río hurtado";"25 a 29";132;130;262
"734";"río hurtado";"30 a 34";140;131;271
"735";"río hurtado";"35 a 39";119;111;230
"736";"río hurtado";"40 a 44";128;132;260
"737";"río hurtado";"45 a 49";142;135;277
"738";"río hurtado";"50 a 54";162;157;319
"739";"río hurtado";"55 a 59";165;149;314
"740";"río hurtado";"60 a 64";166;141;307
"741";"río hurtado";"65 a 69";105;121;226
"742";"río hurtado";"70 a 74";108;124;232
"743";"río hurtado";"75 a 79";81;92;173
"744";"río hurtado";"80 a 84";37;62;99
"745";"río hurtado";"85 a 89";36;36;72
"746";"río hurtado";"90 a 94";13;13;26
"747";"río hurtado";"95 a 99";7;7;14
"748";"río hurtado";"100 o más";1;0;1
"749";"valparaíso";"20 a 24";14799;13400;28199
"750";"valparaíso";"25 a 29";13507;12467;25974
"751";"valparaíso";"30 a 34";10597;10310;20907
"752";"valparaíso";"35 a 39";9520;9375;18895
"753";"valparaíso";"40 a 44";8866;9243;18109
"754";"valparaíso";"45 a 49";8561;9230;17791
"755";"valparaíso";"50 a 54";9204;9968;19172
"756";"valparaíso";"55 a 59";8434;9648;18082
"757";"valparaíso";"60 a 64";6993;8202;15195
"758";"valparaíso";"65 a 69";5572;6790;12362
"759";"valparaíso";"70 a 74";4482;5699;10181
"760";"valparaíso";"75 a 79";2823;4261;7084
"761";"valparaíso";"80 a 84";1794;3136;4930
"762";"valparaíso";"85 a 89";1059;2339;3398
"763";"valparaíso";"90 a 94";353;900;1253
"764";"valparaíso";"95 a 99";72;246;318
"765";"valparaíso";"100 o más";33;64;97
"766";"casablanca";"20 a 24";1060;944;2004
"767";"casablanca";"25 a 29";1082;1034;2116
"768";"casablanca";"30 a 34";882;920;1802
"769";"casablanca";"35 a 39";878;933;1811
"770";"casablanca";"40 a 44";934;923;1857
"771";"casablanca";"45 a 49";930;931;1861
"772";"casablanca";"50 a 54";967;953;1920
"773";"casablanca";"55 a 59";852;848;1700
"774";"casablanca";"60 a 64";605;643;1248
"775";"casablanca";"65 a 69";495;525;1020
"776";"casablanca";"70 a 74";368;416;784
"777";"casablanca";"75 a 79";304;328;632
"778";"casablanca";"80 a 84";189;241;430
"779";"casablanca";"85 a 89";101;148;249
"780";"casablanca";"90 a 94";36;57;93
"781";"casablanca";"95 a 99";13;22;35
"782";"casablanca";"100 o más";1;8;9
"783";"concón";"20 a 24";1825;1592;3417
"784";"concón";"25 a 29";1608;1631;3239
"785";"concón";"30 a 34";1343;1363;2706
"786";"concón";"35 a 39";1270;1397;2667
"787";"concón";"40 a 44";1307;1557;2864
"788";"concón";"45 a 49";1354;1545;2899
"789";"concón";"50 a 54";1438;1641;3079
"790";"concón";"55 a 59";1249;1505;2754
"791";"concón";"60 a 64";991;1169;2160
"792";"concón";"65 a 69";718;866;1584
"793";"concón";"70 a 74";600;723;1323
"794";"concón";"75 a 79";355;534;889
"795";"concón";"80 a 84";239;357;596
"796";"concón";"85 a 89";117;213;330
"797";"concón";"90 a 94";37;100;137
"798";"concón";"95 a 99";8;24;32
"799";"concón";"100 o más";0;4;4
"800";"juan fernández";"20 a 24";20;12;32
"801";"juan fernández";"25 a 29";54;41;95
"802";"juan fernández";"30 a 34";52;48;100
"803";"juan fernández";"35 a 39";45;39;84
"804";"juan fernández";"40 a 44";37;28;65
"805";"juan fernández";"45 a 49";38;23;61
"806";"juan fernández";"50 a 54";34;28;62
"807";"juan fernández";"55 a 59";25;31;56
"808";"juan fernández";"60 a 64";30;26;56
"809";"juan fernández";"65 a 69";23;10;33
"810";"juan fernández";"70 a 74";9;9;18
"811";"juan fernández";"75 a 79";5;10;15
"812";"juan fernández";"80 a 84";4;1;5
"813";"juan fernández";"85 a 89";3;2;5
"814";"juan fernández";"90 a 94";0;3;3
"815";"juan fernández";"95 a 99";0;0;0
"816";"juan fernández";"100 o más";1;0;1
"817";"puchuncaví";"20 a 24";651;585;1236
"818";"puchuncaví";"25 a 29";650;683;1333
"819";"puchuncaví";"30 a 34";670;595;1265
"820";"puchuncaví";"35 a 39";566;607;1173
"821";"puchuncaví";"40 a 44";627;593;1220
"822";"puchuncaví";"45 a 49";632;568;1200
"823";"puchuncaví";"50 a 54";657;651;1308
"824";"puchuncaví";"55 a 59";625;622;1247
"825";"puchuncaví";"60 a 64";506;535;1041
"826";"puchuncaví";"65 a 69";421;451;872
"827";"puchuncaví";"70 a 74";336;367;703
"828";"puchuncaví";"75 a 79";237;247;484
"829";"puchuncaví";"80 a 84";154;202;356
"830";"puchuncaví";"85 a 89";81;101;182
"831";"puchuncaví";"90 a 94";20;39;59
"832";"puchuncaví";"95 a 99";2;13;15
"833";"puchuncaví";"100 o más";1;0;1
"834";"quintero";"20 a 24";1204;1175;2379
"835";"quintero";"25 a 29";1193;1072;2265
"836";"quintero";"30 a 34";1066;1082;2148
"837";"quintero";"35 a 39";967;1036;2003
"838";"quintero";"40 a 44";1012;1014;2026
"839";"quintero";"45 a 49";1049;1014;2063
"840";"quintero";"50 a 54";1082;1098;2180
"841";"quintero";"55 a 59";961;1067;2028
"842";"quintero";"60 a 64";796;833;1629
"843";"quintero";"65 a 69";635;700;1335
"844";"quintero";"70 a 74";517;613;1130
"845";"quintero";"75 a 79";407;448;855
"846";"quintero";"80 a 84";205;317;522
"847";"quintero";"85 a 89";125;162;287
"848";"quintero";"90 a 94";32;62;94
"849";"quintero";"95 a 99";10;22;32
"850";"quintero";"100 o más";0;3;3
"851";"viña del mar";"20 a 24";16945;15989;32934
"852";"viña del mar";"25 a 29";14602;14320;28922
"853";"viña del mar";"30 a 34";11544;11745;23289
"854";"viña del mar";"35 a 39";10049;10460;20509
"855";"viña del mar";"40 a 44";9270;10177;19447
"856";"viña del mar";"45 a 49";8862;10235;19097
"857";"viña del mar";"50 a 54";9829;11781;21610
"858";"viña del mar";"55 a 59";9247;11682;20929
"859";"viña del mar";"60 a 64";7841;9911;17752
"860";"viña del mar";"65 a 69";6256;8068;14324
"861";"viña del mar";"70 a 74";5171;7038;12209
"862";"viña del mar";"75 a 79";3637;5575;9212
"863";"viña del mar";"80 a 84";2556;4299;6855
"864";"viña del mar";"85 a 89";1509;3156;4665
"865";"viña del mar";"90 a 94";453;1323;1776
"866";"viña del mar";"95 a 99";106;363;469
"867";"viña del mar";"100 o más";26;92;118
"868";"isla de pascua";"20 a 24";242;234;476
"869";"isla de pascua";"25 a 29";404;491;895
"870";"isla de pascua";"30 a 34";400;447;847
"871";"isla de pascua";"35 a 39";340;348;688
"872";"isla de pascua";"40 a 44";308;311;619
"873";"isla de pascua";"45 a 49";242;244;486
"874";"isla de pascua";"50 a 54";251;249;500
"875";"isla de pascua";"55 a 59";181;196;377
"876";"isla de pascua";"60 a 64";160;163;323
"877";"isla de pascua";"65 a 69";113;113;226
"878";"isla de pascua";"70 a 74";68;63;131
"879";"isla de pascua";"75 a 79";33;33;66
"880";"isla de pascua";"80 a 84";12;21;33
"881";"isla de pascua";"85 a 89";2;13;15
"882";"isla de pascua";"90 a 94";0;3;3
"883";"isla de pascua";"95 a 99";1;0;1
"884";"isla de pascua";"100 o más";0;0;0
"885";"los andes";"20 a 24";2450;2270;4720
"886";"los andes";"25 a 29";2779;2431;5210
"887";"los andes";"30 a 34";2417;2331;4748
"888";"los andes";"35 a 39";2569;2287;4856
"889";"los andes";"40 a 44";2397;2272;4669
"890";"los andes";"45 a 49";2157;2280;4437
"891";"los andes";"50 a 54";2209;2241;4450
"892";"los andes";"55 a 59";1891;2112;4003
"893";"los andes";"60 a 64";1590;1847;3437
"894";"los andes";"65 a 69";1286;1403;2689
"895";"los andes";"70 a 74";1026;1129;2155
"896";"los andes";"75 a 79";584;753;1337
"897";"los andes";"80 a 84";339;565;904
"898";"los andes";"85 a 89";229;404;633
"899";"los andes";"90 a 94";64;145;209
"900";"los andes";"95 a 99";17;55;72
"901";"los andes";"100 o más";9;16;25
"902";"calle larga";"20 a 24";475;484;959
"903";"calle larga";"25 a 29";611;606;1217
"904";"calle larga";"30 a 34";494;568;1062
"905";"calle larga";"35 a 39";499;532;1031
"906";"calle larga";"40 a 44";465;480;945
"907";"calle larga";"45 a 49";444;538;982
"908";"calle larga";"50 a 54";512;528;1040
"909";"calle larga";"55 a 59";437;458;895
"910";"calle larga";"60 a 64";323;322;645
"911";"calle larga";"65 a 69";283;264;547
"912";"calle larga";"70 a 74";240;205;445
"913";"calle larga";"75 a 79";136;166;302
"914";"calle larga";"80 a 84";90;117;207
"915";"calle larga";"85 a 89";43;72;115
"916";"calle larga";"90 a 94";19;20;39
"917";"calle larga";"95 a 99";4;12;16
"918";"calle larga";"100 o más";3;6;9
"919";"rinconada";"20 a 24";305;318;623
"920";"rinconada";"25 a 29";381;427;808
"921";"rinconada";"30 a 34";333;352;685
"922";"rinconada";"35 a 39";379;415;794
"923";"rinconada";"40 a 44";352;351;703
"924";"rinconada";"45 a 49";370;375;745
"925";"rinconada";"50 a 54";339;357;696
"926";"rinconada";"55 a 59";302;249;551
"927";"rinconada";"60 a 64";226;225;451
"928";"rinconada";"65 a 69";188;180;368
"929";"rinconada";"70 a 74";143;157;300
"930";"rinconada";"75 a 79";101;108;209
"931";"rinconada";"80 a 84";67;71;138
"932";"rinconada";"85 a 89";30;38;68
"933";"rinconada";"90 a 94";9;14;23
"934";"rinconada";"95 a 99";2;8;10
"935";"rinconada";"100 o más";1;1;2
"936";"san esteban";"20 a 24";614;612;1226
"937";"san esteban";"25 a 29";643;733;1376
"938";"san esteban";"30 a 34";662;675;1337
"939";"san esteban";"35 a 39";592;680;1272
"940";"san esteban";"40 a 44";645;684;1329
"941";"san esteban";"45 a 49";610;677;1287
"942";"san esteban";"50 a 54";674;699;1373
"943";"san esteban";"55 a 59";563;561;1124
"944";"san esteban";"60 a 64";451;457;908
"945";"san esteban";"65 a 69";384;343;727
"946";"san esteban";"70 a 74";293;299;592
"947";"san esteban";"75 a 79";186;228;414
"948";"san esteban";"80 a 84";110;149;259
"949";"san esteban";"85 a 89";78;96;174
"950";"san esteban";"90 a 94";25;37;62
"951";"san esteban";"95 a 99";7;8;15
"952";"san esteban";"100 o más";5;1;6
"953";"la ligua";"20 a 24";1075;1057;2132
"954";"la ligua";"25 a 29";1275;1354;2629
"955";"la ligua";"30 a 34";1178;1295;2473
"956";"la ligua";"35 a 39";1091;1063;2154
"957";"la ligua";"40 a 44";1161;1292;2453
"958";"la ligua";"45 a 49";1156;1240;2396
"959";"la ligua";"50 a 54";1335;1442;2777
"960";"la ligua";"55 a 59";1149;1170;2319
"961";"la ligua";"60 a 64";915;976;1891
"962";"la ligua";"65 a 69";753;762;1515
"963";"la ligua";"70 a 74";581;636;1217
"964";"la ligua";"75 a 79";434;537;971
"965";"la ligua";"80 a 84";293;329;622
"966";"la ligua";"85 a 89";145;196;341
"967";"la ligua";"90 a 94";43;59;102
"968";"la ligua";"95 a 99";5;15;20
"969";"la ligua";"100 o más";2;8;10
"970";"cabildo";"20 a 24";584;615;1199
"971";"cabildo";"25 a 29";656;740;1396
"972";"cabildo";"30 a 34";617;705;1322
"973";"cabildo";"35 a 39";631;644;1275
"974";"cabildo";"40 a 44";567;662;1229
"975";"cabildo";"45 a 49";612;717;1329
"976";"cabildo";"50 a 54";682;682;1364
"977";"cabildo";"55 a 59";589;646;1235
"978";"cabildo";"60 a 64";514;499;1013
"979";"cabildo";"65 a 69";387;399;786
"980";"cabildo";"70 a 74";337;282;619
"981";"cabildo";"75 a 79";216;249;465
"982";"cabildo";"80 a 84";141;164;305
"983";"cabildo";"85 a 89";68;94;162
"984";"cabildo";"90 a 94";15;54;69
"985";"cabildo";"95 a 99";6;9;15
"986";"cabildo";"100 o más";2;2;4
"987";"papudo";"20 a 24";223;184;407
"988";"papudo";"25 a 29";250;220;470
"989";"papudo";"30 a 34";231;199;430
"990";"papudo";"35 a 39";194;194;388
"991";"papudo";"40 a 44";200;190;390
"992";"papudo";"45 a 49";207;194;401
"993";"papudo";"50 a 54";270;231;501
"994";"papudo";"55 a 59";199;200;399
"995";"papudo";"60 a 64";158;168;326
"996";"papudo";"65 a 69";134;129;263
"997";"papudo";"70 a 74";96;100;196
"998";"papudo";"75 a 79";72;77;149
"999";"papudo";"80 a 84";40;44;84
"1000";"papudo";"85 a 89";26;38;64
"1001";"papudo";"90 a 94";8;11;19
"1002";"papudo";"95 a 99";2;5;7
"1003";"papudo";"100 o más";1;1;2
"1004";"petorca";"20 a 24";303;308;611
"1005";"petorca";"25 a 29";373;390;763
"1006";"petorca";"30 a 34";294;337;631
"1007";"petorca";"35 a 39";314;307;621
"1008";"petorca";"40 a 44";305;322;627
"1009";"petorca";"45 a 49";329;368;697
"1010";"petorca";"50 a 54";380;359;739
"1011";"petorca";"55 a 59";328;328;656
"1012";"petorca";"60 a 64";285;281;566
"1013";"petorca";"65 a 69";220;234;454
"1014";"petorca";"70 a 74";199;171;370
"1015";"petorca";"75 a 79";133;150;283
"1016";"petorca";"80 a 84";94;93;187
"1017";"petorca";"85 a 89";43;69;112
"1018";"petorca";"90 a 94";11;31;42
"1019";"petorca";"95 a 99";2;11;13
"1020";"petorca";"100 o más";1;0;1
"1021";"zapallar";"20 a 24";246;197;443
"1022";"zapallar";"25 a 29";288;275;563
"1023";"zapallar";"30 a 34";248;265;513
"1024";"zapallar";"35 a 39";250;238;488
"1025";"zapallar";"40 a 44";262;255;517
"1026";"zapallar";"45 a 49";241;214;455
"1027";"zapallar";"50 a 54";289;251;540
"1028";"zapallar";"55 a 59";287;258;545
"1029";"zapallar";"60 a 64";208;215;423
"1030";"zapallar";"65 a 69";163;175;338
"1031";"zapallar";"70 a 74";154;155;309
"1032";"zapallar";"75 a 79";78;104;182
"1033";"zapallar";"80 a 84";57;66;123
"1034";"zapallar";"85 a 89";31;53;84
"1035";"zapallar";"90 a 94";12;19;31
"1036";"zapallar";"95 a 99";2;1;3
"1037";"zapallar";"100 o más";2;3;5
"1038";"quillota";"20 a 24";3463;3304;6767
"1039";"quillota";"25 a 29";3459;3528;6987
"1040";"quillota";"30 a 34";3209;3322;6531
"1041";"quillota";"35 a 39";2789;3040;5829
"1042";"quillota";"40 a 44";2665;3026;5691
"1043";"quillota";"45 a 49";2562;2792;5354
"1044";"quillota";"50 a 54";2846;3316;6162
"1045";"quillota";"55 a 59";2671;3075;5746
"1046";"quillota";"60 a 64";2210;2602;4812
"1047";"quillota";"65 a 69";1752;2014;3766
"1048";"quillota";"70 a 74";1361;1668;3029
"1049";"quillota";"75 a 79";911;1201;2112
"1050";"quillota";"80 a 84";589;957;1546
"1051";"quillota";"85 a 89";364;651;1015
"1052";"quillota";"90 a 94";117;278;395
"1053";"quillota";"95 a 99";21;69;90
"1054";"quillota";"100 o más";9;19;28
"1055";"calera";"20 a 24";1884;1870;3754
"1056";"calera";"25 a 29";1897;1944;3841
"1057";"calera";"30 a 34";1716;1753;3469
"1058";"calera";"35 a 39";1472;1604;3076
"1059";"calera";"40 a 44";1511;1708;3219
"1060";"calera";"45 a 49";1431;1610;3041
"1061";"calera";"50 a 54";1622;1832;3454
"1062";"calera";"55 a 59";1439;1705;3144
"1063";"calera";"60 a 64";1322;1408;2730
"1064";"calera";"65 a 69";933;1136;2069
"1065";"calera";"70 a 74";764;941;1705
"1066";"calera";"75 a 79";586;704;1290
"1067";"calera";"80 a 84";322;472;794
"1068";"calera";"85 a 89";204;322;526
"1069";"calera";"90 a 94";59;117;176
"1070";"calera";"95 a 99";7;19;26
"1071";"calera";"100 o más";5;13;18
"1072";"hijuelas";"20 a 24";690;669;1359
"1073";"hijuelas";"25 a 29";659;686;1345
"1074";"hijuelas";"30 a 34";623;602;1225
"1075";"hijuelas";"35 a 39";557;567;1124
"1076";"hijuelas";"40 a 44";587;655;1242
"1077";"hijuelas";"45 a 49";611;568;1179
"1078";"hijuelas";"50 a 54";665;699;1364
"1079";"hijuelas";"55 a 59";587;553;1140
"1080";"hijuelas";"60 a 64";445;445;890
"1081";"hijuelas";"65 a 69";351;347;698
"1082";"hijuelas";"70 a 74";283;263;546
"1083";"hijuelas";"75 a 79";189;210;399
"1084";"hijuelas";"80 a 84";114;131;245
"1085";"hijuelas";"85 a 89";58;102;160
"1086";"hijuelas";"90 a 94";27;31;58
"1087";"hijuelas";"95 a 99";4;8;12
"1088";"hijuelas";"100 o más";2;4;6
"1089";"la cruz";"20 a 24";674;723;1397
"1090";"la cruz";"25 a 29";850;952;1802
"1091";"la cruz";"30 a 34";893;1026;1919
"1092";"la cruz";"35 a 39";848;962;1810
"1093";"la cruz";"40 a 44";735;794;1529
"1094";"la cruz";"45 a 49";635;730;1365
"1095";"la cruz";"50 a 54";612;712;1324
"1096";"la cruz";"55 a 59";559;587;1146
"1097";"la cruz";"60 a 64";445;477;922
"1098";"la cruz";"65 a 69";338;376;714
"1099";"la cruz";"70 a 74";279;327;606
"1100";"la cruz";"75 a 79";186;242;428
"1101";"la cruz";"80 a 84";120;153;273
"1102";"la cruz";"85 a 89";55;114;169
"1103";"la cruz";"90 a 94";25;31;56
"1104";"la cruz";"95 a 99";9;15;24
"1105";"la cruz";"100 o más";2;5;7
"1106";"nogales";"20 a 24";804;830;1634
"1107";"nogales";"25 a 29";799;784;1583
"1108";"nogales";"30 a 34";678;704;1382
"1109";"nogales";"35 a 39";583;672;1255
"1110";"nogales";"40 a 44";640;789;1429
"1111";"nogales";"45 a 49";671;723;1394
"1112";"nogales";"50 a 54";766;836;1602
"1113";"nogales";"55 a 59";724;718;1442
"1114";"nogales";"60 a 64";560;574;1134
"1115";"nogales";"65 a 69";450;484;934
"1116";"nogales";"70 a 74";356;405;761
"1117";"nogales";"75 a 79";252;297;549
"1118";"nogales";"80 a 84";135;219;354
"1119";"nogales";"85 a 89";87;136;223
"1120";"nogales";"90 a 94";28;49;77
"1121";"nogales";"95 a 99";7;17;24
"1122";"nogales";"100 o más";1;5;6
"1123";"san antonio";"20 a 24";3129;3041;6170
"1124";"san antonio";"25 a 29";3581;3455;7036
"1125";"san antonio";"30 a 34";3159;3126;6285
"1126";"san antonio";"35 a 39";2980;3104;6084
"1127";"san antonio";"40 a 44";3076;2989;6065
"1128";"san antonio";"45 a 49";2907;3015;5922
"1129";"san antonio";"50 a 54";3119;3311;6430
"1130";"san antonio";"55 a 59";2891;3161;6052
"1131";"san antonio";"60 a 64";2264;2578;4842
"1132";"san antonio";"65 a 69";1787;2035;3822
"1133";"san antonio";"70 a 74";1315;1611;2926
"1134";"san antonio";"75 a 79";873;1281;2154
"1135";"san antonio";"80 a 84";546;850;1396
"1136";"san antonio";"85 a 89";323;587;910
"1137";"san antonio";"90 a 94";85;229;314
"1138";"san antonio";"95 a 99";31;48;79
"1139";"san antonio";"100 o más";17;11;28
"1140";"algarrobo";"20 a 24";389;362;751
"1141";"algarrobo";"25 a 29";423;421;844
"1142";"algarrobo";"30 a 34";443;461;904
"1143";"algarrobo";"35 a 39";436;447;883
"1144";"algarrobo";"40 a 44";452;445;897
"1145";"algarrobo";"45 a 49";425;430;855
"1146";"algarrobo";"50 a 54";452;483;935
"1147";"algarrobo";"55 a 59";466;519;985
"1148";"algarrobo";"60 a 64";415;461;876
"1149";"algarrobo";"65 a 69";398;466;864
"1150";"algarrobo";"70 a 74";354;393;747
"1151";"algarrobo";"75 a 79";243;272;515
"1152";"algarrobo";"80 a 84";120;161;281
"1153";"algarrobo";"85 a 89";77;91;168
"1154";"algarrobo";"90 a 94";21;43;64
"1155";"algarrobo";"95 a 99";6;21;27
"1156";"algarrobo";"100 o más";3;1;4
"1157";"cartagena";"20 a 24";693;703;1396
"1158";"cartagena";"25 a 29";806;770;1576
"1159";"cartagena";"30 a 34";735;703;1438
"1160";"cartagena";"35 a 39";666;661;1327
"1161";"cartagena";"40 a 44";651;658;1309
"1162";"cartagena";"45 a 49";714;700;1414
"1163";"cartagena";"50 a 54";771;768;1539
"1164";"cartagena";"55 a 59";784;785;1569
"1165";"cartagena";"60 a 64";658;701;1359
"1166";"cartagena";"65 a 69";578;648;1226
"1167";"cartagena";"70 a 74";461;555;1016
"1168";"cartagena";"75 a 79";357;381;738
"1169";"cartagena";"80 a 84";197;240;437
"1170";"cartagena";"85 a 89";119;145;264
"1171";"cartagena";"90 a 94";25;53;78
"1172";"cartagena";"95 a 99";5;21;26
"1173";"cartagena";"100 o más";0;6;6
"1174";"el quisco";"20 a 24";424;412;836
"1175";"el quisco";"25 a 29";470;482;952
"1176";"el quisco";"30 a 34";480;483;963
"1177";"el quisco";"35 a 39";485;481;966
"1178";"el quisco";"40 a 44";508;512;1020
"1179";"el quisco";"45 a 49";471;473;944
"1180";"el quisco";"50 a 54";544;517;1061
"1181";"el quisco";"55 a 59";503;576;1079
"1182";"el quisco";"60 a 64";489;546;1035
"1183";"el quisco";"65 a 69";468;530;998
"1184";"el quisco";"70 a 74";435;500;935
"1185";"el quisco";"75 a 79";310;356;666
"1186";"el quisco";"80 a 84";189;217;406
"1187";"el quisco";"85 a 89";112;125;237
"1188";"el quisco";"90 a 94";35;47;82
"1189";"el quisco";"95 a 99";4;16;20
"1190";"el quisco";"100 o más";2;2;4
"1191";"el tabo";"20 a 24";339;349;688
"1192";"el tabo";"25 a 29";424;392;816
"1193";"el tabo";"30 a 34";440;395;835
"1194";"el tabo";"35 a 39";397;359;756
"1195";"el tabo";"40 a 44";387;407;794
"1196";"el tabo";"45 a 49";438;384;822
"1197";"el tabo";"50 a 54";459;458;917
"1198";"el tabo";"55 a 59";489;504;993
"1199";"el tabo";"60 a 64";419;522;941
"1200";"el tabo";"65 a 69";441;447;888
"1201";"el tabo";"70 a 74";405;403;808
"1202";"el tabo";"75 a 79";239;268;507
"1203";"el tabo";"80 a 84";148;170;318
"1204";"el tabo";"85 a 89";72;98;170
"1205";"el tabo";"90 a 94";12;33;45
"1206";"el tabo";"95 a 99";5;11;16
"1207";"el tabo";"100 o más";2;3;5
"1208";"santo domingo";"20 a 24";263;283;546
"1209";"santo domingo";"25 a 29";367;354;721
"1210";"santo domingo";"30 a 34";371;389;760
"1211";"santo domingo";"35 a 39";357;395;752
"1212";"santo domingo";"40 a 44";420;413;833
"1213";"santo domingo";"45 a 49";408;399;807
"1214";"santo domingo";"50 a 54";431;389;820
"1215";"santo domingo";"55 a 59";353;357;710
"1216";"santo domingo";"60 a 64";305;312;617
"1217";"santo domingo";"65 a 69";237;227;464
"1218";"santo domingo";"70 a 74";183;213;396
"1219";"santo domingo";"75 a 79";130;125;255
"1220";"santo domingo";"80 a 84";73;87;160
"1221";"santo domingo";"85 a 89";51;73;124
"1222";"santo domingo";"90 a 94";14;30;44
"1223";"santo domingo";"95 a 99";2;9;11
"1224";"santo domingo";"100 o más";0;3;3
"1225";"san felipe";"20 a 24";2757;2820;5577
"1226";"san felipe";"25 a 29";3180;3186;6366
"1227";"san felipe";"30 a 34";2872;2909;5781
"1228";"san felipe";"35 a 39";2604;2711;5315
"1229";"san felipe";"40 a 44";2446;2586;5032
"1230";"san felipe";"45 a 49";2234;2432;4666
"1231";"san felipe";"50 a 54";2407;2778;5185
"1232";"san felipe";"55 a 59";2118;2427;4545
"1233";"san felipe";"60 a 64";1759;1974;3733
"1234";"san felipe";"65 a 69";1369;1526;2895
"1235";"san felipe";"70 a 74";1041;1238;2279
"1236";"san felipe";"75 a 79";669;904;1573
"1237";"san felipe";"80 a 84";439;666;1105
"1238";"san felipe";"85 a 89";229;497;726
"1239";"san felipe";"90 a 94";93;182;275
"1240";"san felipe";"95 a 99";15;58;73
"1241";"san felipe";"100 o más";3;17;20
"1242";"catemu";"20 a 24";494;439;933
"1243";"catemu";"25 a 29";546;507;1053
"1244";"catemu";"30 a 34";477;521;998
"1245";"catemu";"35 a 39";444;479;923
"1246";"catemu";"40 a 44";430;503;933
"1247";"catemu";"45 a 49";471;474;945
"1248";"catemu";"50 a 54";466;476;942
"1249";"catemu";"55 a 59";432;410;842
"1250";"catemu";"60 a 64";345;353;698
"1251";"catemu";"65 a 69";303;302;605
"1252";"catemu";"70 a 74";238;217;455
"1253";"catemu";"75 a 79";164;212;376
"1254";"catemu";"80 a 84";111;100;211
"1255";"catemu";"85 a 89";60;77;137
"1256";"catemu";"90 a 94";20;36;56
"1257";"catemu";"95 a 99";11;8;19
"1258";"catemu";"100 o más";0;2;2
"1259";"llaillay";"20 a 24";842;837;1679
"1260";"llaillay";"25 a 29";941;977;1918
"1261";"llaillay";"30 a 34";863;873;1736
"1262";"llaillay";"35 a 39";765;791;1556
"1263";"llaillay";"40 a 44";756;840;1596
"1264";"llaillay";"45 a 49";814;860;1674
"1265";"llaillay";"50 a 54";859;824;1683
"1266";"llaillay";"55 a 59";759;762;1521
"1267";"llaillay";"60 a 64";617;668;1285
"1268";"llaillay";"65 a 69";491;490;981
"1269";"llaillay";"70 a 74";376;417;793
"1270";"llaillay";"75 a 79";239;278;517
"1271";"llaillay";"80 a 84";181;205;386
"1272";"llaillay";"85 a 89";100;142;242
"1273";"llaillay";"90 a 94";35;57;92
"1274";"llaillay";"95 a 99";6;7;13
"1275";"llaillay";"100 o más";4;8;12
"1276";"panquehue";"20 a 24";245;248;493
"1277";"panquehue";"25 a 29";269;277;546
"1278";"panquehue";"30 a 34";263;240;503
"1279";"panquehue";"35 a 39";238;232;470
"1280";"panquehue";"40 a 44";261;244;505
"1281";"panquehue";"45 a 49";247;227;474
"1282";"panquehue";"50 a 54";241;261;502
"1283";"panquehue";"55 a 59";231;244;475
"1284";"panquehue";"60 a 64";213;197;410
"1285";"panquehue";"65 a 69";157;154;311
"1286";"panquehue";"70 a 74";117;111;228
"1287";"panquehue";"75 a 79";64;71;135
"1288";"panquehue";"80 a 84";43;42;85
"1289";"panquehue";"85 a 89";19;35;54
"1290";"panquehue";"90 a 94";9;15;24
"1291";"panquehue";"95 a 99";2;6;8
"1292";"panquehue";"100 o más";1;2;3
"1293";"putaendo";"20 a 24";611;541;1152
"1294";"putaendo";"25 a 29";559;591;1150
"1295";"putaendo";"30 a 34";526;546;1072
"1296";"putaendo";"35 a 39";544;505;1049
"1297";"putaendo";"40 a 44";533;561;1094
"1298";"putaendo";"45 a 49";527;542;1069
"1299";"putaendo";"50 a 54";602;657;1259
"1300";"putaendo";"55 a 59";565;520;1085
"1301";"putaendo";"60 a 64";440;432;872
"1302";"putaendo";"65 a 69";365;363;728
"1303";"putaendo";"70 a 74";313;338;651
"1304";"putaendo";"75 a 79";204;266;470
"1305";"putaendo";"80 a 84";151;204;355
"1306";"putaendo";"85 a 89";83;102;185
"1307";"putaendo";"90 a 94";26;51;77
"1308";"putaendo";"95 a 99";6;17;23
"1309";"putaendo";"100 o más";3;2;5
"1310";"santa maría";"20 a 24";546;548;1094
"1311";"santa maría";"25 a 29";563;591;1154
"1312";"santa maría";"30 a 34";497;532;1029
"1313";"santa maría";"35 a 39";524;520;1044
"1314";"santa maría";"40 a 44";448;471;919
"1315";"santa maría";"45 a 49";459;476;935
"1316";"santa maría";"50 a 54";550;610;1160
"1317";"santa maría";"55 a 59";507;497;1004
"1318";"santa maría";"60 a 64";377;399;776
"1319";"santa maría";"65 a 69";319;289;608
"1320";"santa maría";"70 a 74";235;267;502
"1321";"santa maría";"75 a 79";175;180;355
"1322";"santa maría";"80 a 84";108;122;230
"1323";"santa maría";"85 a 89";56;80;136
"1324";"santa maría";"90 a 94";13;36;49
"1325";"santa maría";"95 a 99";3;7;10
"1326";"santa maría";"100 o más";2;5;7
"1327";"quilpué";"20 a 24";6011;5905;11916
"1328";"quilpué";"25 a 29";5770;5736;11506
"1329";"quilpué";"30 a 34";4655;5010;9665
"1330";"quilpué";"35 a 39";4477;5025;9502
"1331";"quilpué";"40 a 44";4557;5261;9818
"1332";"quilpué";"45 a 49";4484;5270;9754
"1333";"quilpué";"50 a 54";4678;5790;10468
"1334";"quilpué";"55 a 59";4431;5421;9852
"1335";"quilpué";"60 a 64";3737;4464;8201
"1336";"quilpué";"65 a 69";3042;3656;6698
"1337";"quilpué";"70 a 74";2412;3324;5736
"1338";"quilpué";"75 a 79";1644;2398;4042
"1339";"quilpué";"80 a 84";1099;1818;2917
"1340";"quilpué";"85 a 89";617;1238;1855
"1341";"quilpué";"90 a 94";198;535;733
"1342";"quilpué";"95 a 99";50;154;204
"1343";"quilpué";"100 o más";19;42;61
"1344";"limache";"20 a 24";1718;1697;3415
"1345";"limache";"25 a 29";1692;1679;3371
"1346";"limache";"30 a 34";1433;1467;2900
"1347";"limache";"35 a 39";1440;1593;3033
"1348";"limache";"40 a 44";1506;1615;3121
"1349";"limache";"45 a 49";1447;1488;2935
"1350";"limache";"50 a 54";1492;1704;3196
"1351";"limache";"55 a 59";1327;1426;2753
"1352";"limache";"60 a 64";1008;1247;2255
"1353";"limache";"65 a 69";872;1029;1901
"1354";"limache";"70 a 74";792;942;1734
"1355";"limache";"75 a 79";562;655;1217
"1356";"limache";"80 a 84";338;471;809
"1357";"limache";"85 a 89";180;342;522
"1358";"limache";"90 a 94";48;151;199
"1359";"limache";"95 a 99";13;39;52
"1360";"limache";"100 o más";6;7;13
"1361";"olmué";"20 a 24";591;615;1206
"1362";"olmué";"25 a 29";595;619;1214
"1363";"olmué";"30 a 34";572;553;1125
"1364";"olmué";"35 a 39";558;595;1153
"1365";"olmué";"40 a 44";532;564;1096
"1366";"olmué";"45 a 49";516;511;1027
"1367";"olmué";"50 a 54";597;622;1219
"1368";"olmué";"55 a 59";565;595;1160
"1369";"olmué";"60 a 64";492;533;1025
"1370";"olmué";"65 a 69";424;460;884
"1371";"olmué";"70 a 74";363;405;768
"1372";"olmué";"75 a 79";244;247;491
"1373";"olmué";"80 a 84";146;163;309
"1374";"olmué";"85 a 89";100;111;211
"1375";"olmué";"90 a 94";24;54;78
"1376";"olmué";"95 a 99";8;18;26
"1377";"olmué";"100 o más";1;5;6
"1378";"villa alemana";"20 a 24";4942;4837;9779
"1379";"villa alemana";"25 a 29";4730;4747;9477
"1380";"villa alemana";"30 a 34";4145;4391;8536
"1381";"villa alemana";"35 a 39";3848;4387;8235
"1382";"villa alemana";"40 a 44";3827;4447;8274
"1383";"villa alemana";"45 a 49";3638;4438;8076
"1384";"villa alemana";"50 a 54";3844;4609;8453
"1385";"villa alemana";"55 a 59";3595;4454;8049
"1386";"villa alemana";"60 a 64";2890;3555;6445
"1387";"villa alemana";"65 a 69";2198;2795;4993
"1388";"villa alemana";"70 a 74";1784;2466;4250
"1389";"villa alemana";"75 a 79";1207;1774;2981
"1390";"villa alemana";"80 a 84";807;1310;2117
"1391";"villa alemana";"85 a 89";479;926;1405
"1392";"villa alemana";"90 a 94";149;446;595
"1393";"villa alemana";"95 a 99";27;101;128
"1394";"villa alemana";"100 o más";8;24;32
"1395";"santiago";"20 a 24";21956;19661;41617
"1396";"santiago";"25 a 29";35378;31481;66859
"1397";"santiago";"30 a 34";32266;26278;58544
"1398";"santiago";"35 a 39";22274;18369;40643
"1399";"santiago";"40 a 44";15327;13717;29044
"1400";"santiago";"45 a 49";11078;10725;21803
"1401";"santiago";"50 a 54";9587;9941;19528
"1402";"santiago";"55 a 59";7486;8987;16473
"1403";"santiago";"60 a 64";5686;7134;12820
"1404";"santiago";"65 a 69";4083;5382;9465
"1405";"santiago";"70 a 74";3098;4351;7449
"1406";"santiago";"75 a 79";2027;3301;5328
"1407";"santiago";"80 a 84";1258;2480;3738
"1408";"santiago";"85 a 89";733;1869;2602
"1409";"santiago";"90 a 94";241;786;1027
"1410";"santiago";"95 a 99";63;239;302
"1411";"santiago";"100 o más";41;67;108
"1412";"cerrillos";"20 a 24";3767;3404;7171
"1413";"cerrillos";"25 a 29";3306;3150;6456
"1414";"cerrillos";"30 a 34";2859;2835;5694
"1415";"cerrillos";"35 a 39";2635;2763;5398
"1416";"cerrillos";"40 a 44";2840;2787;5627
"1417";"cerrillos";"45 a 49";2596;2679;5275
"1418";"cerrillos";"50 a 54";2612;2784;5396
"1419";"cerrillos";"55 a 59";2108;2402;4510
"1420";"cerrillos";"60 a 64";1632;1970;3602
"1421";"cerrillos";"65 a 69";1331;1632;2963
"1422";"cerrillos";"70 a 74";1051;1499;2550
"1423";"cerrillos";"75 a 79";722;1140;1862
"1424";"cerrillos";"80 a 84";447;707;1154
"1425";"cerrillos";"85 a 89";248;490;738
"1426";"cerrillos";"90 a 94";71;196;267
"1427";"cerrillos";"95 a 99";12;45;57
"1428";"cerrillos";"100 o más";4;14;18
"1429";"cerro navia";"20 a 24";5790;5751;11541
"1430";"cerro navia";"25 a 29";5873;5300;11173
"1431";"cerro navia";"30 a 34";4566;4332;8898
"1432";"cerro navia";"35 a 39";4110;4032;8142
"1433";"cerro navia";"40 a 44";4465;4390;8855
"1434";"cerro navia";"45 a 49";4594;4521;9115
"1435";"cerro navia";"50 a 54";4457;4606;9063
"1436";"cerro navia";"55 a 59";3642;3824;7466
"1437";"cerro navia";"60 a 64";2788;3225;6013
"1438";"cerro navia";"65 a 69";2377;2963;5340
"1439";"cerro navia";"70 a 74";2053;2497;4550
"1440";"cerro navia";"75 a 79";1296;1864;3160
"1441";"cerro navia";"80 a 84";680;1162;1842
"1442";"cerro navia";"85 a 89";356;672;1028
"1443";"cerro navia";"90 a 94";104;236;340
"1444";"cerro navia";"95 a 99";22;81;103
"1445";"cerro navia";"100 o más";21;13;34
"1446";"conchalí";"20 a 24";5422;5081;10503
"1447";"conchalí";"25 a 29";5613;5207;10820
"1448";"conchalí";"30 a 34";4534;4283;8817
"1449";"conchalí";"35 a 39";4023;3865;7888
"1450";"conchalí";"40 a 44";4050;4083;8133
"1451";"conchalí";"45 a 49";4123;4152;8275
"1452";"conchalí";"50 a 54";4313;4659;8972
"1453";"conchalí";"55 a 59";3783;4158;7941
"1454";"conchalí";"60 a 64";2766;3222;5988
"1455";"conchalí";"65 a 69";2110;2691;4801
"1456";"conchalí";"70 a 74";1857;2393;4250
"1457";"conchalí";"75 a 79";1371;2162;3533
"1458";"conchalí";"80 a 84";926;1595;2521
"1459";"conchalí";"85 a 89";510;1115;1625
"1460";"conchalí";"90 a 94";163;389;552
"1461";"conchalí";"95 a 99";34;93;127
"1462";"conchalí";"100 o más";9;34;43
"1463";"el bosque";"20 a 24";6798;6505;13303
"1464";"el bosque";"25 a 29";7302;6812;14114
"1465";"el bosque";"30 a 34";5604;5529;11133
"1466";"el bosque";"35 a 39";4988;5033;10021
"1467";"el bosque";"40 a 44";4871;4941;9812
"1468";"el bosque";"45 a 49";4974;5158;10132
"1469";"el bosque";"50 a 54";5312;5711;11023
"1470";"el bosque";"55 a 59";4732;5359;10091
"1471";"el bosque";"60 a 64";3768;4444;8212
"1472";"el bosque";"65 a 69";2861;3487;6348
"1473";"el bosque";"70 a 74";2304;3048;5352
"1474";"el bosque";"75 a 79";1475;2262;3737
"1475";"el bosque";"80 a 84";917;1445;2362
"1476";"el bosque";"85 a 89";483;990;1473
"1477";"el bosque";"90 a 94";117;335;452
"1478";"el bosque";"95 a 99";25;79;104
"1479";"el bosque";"100 o más";15;27;42
"1480";"estación central";"20 a 24";7153;6604;13757
"1481";"estación central";"25 a 29";8702;7590;16292
"1482";"estación central";"30 a 34";7036;5994;13030
"1483";"estación central";"35 a 39";5644;4992;10636
"1484";"estación central";"40 a 44";5091;4470;9561
"1485";"estación central";"45 a 49";4514;4451;8965
"1486";"estación central";"50 a 54";4651;5025;9676
"1487";"estación central";"55 a 59";3978;4387;8365
"1488";"estación central";"60 a 64";3117;3514;6631
"1489";"estación central";"65 a 69";2229;2880;5109
"1490";"estación central";"70 a 74";1888;2599;4487
"1491";"estación central";"75 a 79";1334;2027;3361
"1492";"estación central";"80 a 84";823;1401;2224
"1493";"estación central";"85 a 89";469;999;1468
"1494";"estación central";"90 a 94";172;395;567
"1495";"estación central";"95 a 99";39;113;152
"1496";"estación central";"100 o más";11;25;36
"1497";"huechuraba";"20 a 24";3798;3711;7509
"1498";"huechuraba";"25 a 29";3506;3453;6959
"1499";"huechuraba";"30 a 34";3117;3373;6490
"1500";"huechuraba";"35 a 39";3512;3731;7243
"1501";"huechuraba";"40 a 44";3922;4350;8272
"1502";"huechuraba";"45 a 49";3862;3996;7858
"1503";"huechuraba";"50 a 54";3222;3248;6470
"1504";"huechuraba";"55 a 59";2212;2296;4508
"1505";"huechuraba";"60 a 64";1542;1874;3416
"1506";"huechuraba";"65 a 69";1367;1794;3161
"1507";"huechuraba";"70 a 74";1231;1573;2804
"1508";"huechuraba";"75 a 79";742;990;1732
"1509";"huechuraba";"80 a 84";370;629;999
"1510";"huechuraba";"85 a 89";177;323;500
"1511";"huechuraba";"90 a 94";34;126;160
"1512";"huechuraba";"95 a 99";7;27;34
"1513";"huechuraba";"100 o más";10;13;23
"1514";"independencia";"20 a 24";4865;4810;9675
"1515";"independencia";"25 a 29";6368;5831;12199
"1516";"independencia";"30 a 34";5254;4710;9964
"1517";"independencia";"35 a 39";4124;3824;7948
"1518";"independencia";"40 a 44";3411;3502;6913
"1519";"independencia";"45 a 49";2759;3059;5818
"1520";"independencia";"50 a 54";2638;2881;5519
"1521";"independencia";"55 a 59";2151;2639;4790
"1522";"independencia";"60 a 64";1847;2251;4098
"1523";"independencia";"65 a 69";1423;1813;3236
"1524";"independencia";"70 a 74";1202;1619;2821
"1525";"independencia";"75 a 79";768;1164;1932
"1526";"independencia";"80 a 84";455;944;1399
"1527";"independencia";"85 a 89";299;672;971
"1528";"independencia";"90 a 94";92;371;463
"1529";"independencia";"95 a 99";27;113;140
"1530";"independencia";"100 o más";7;36;43
"1531";"la cisterna";"20 a 24";3650;3399;7049
"1532";"la cisterna";"25 a 29";4070;4057;8127
"1533";"la cisterna";"30 a 34";3672;3564;7236
"1534";"la cisterna";"35 a 39";3042;3107;6149
"1535";"la cisterna";"40 a 44";2811;2907;5718
"1536";"la cisterna";"45 a 49";2626;2884;5510
"1537";"la cisterna";"50 a 54";2652;2978;5630
"1538";"la cisterna";"55 a 59";2537;2964;5501
"1539";"la cisterna";"60 a 64";2034;2505;4539
"1540";"la cisterna";"65 a 69";1656;2098;3754
"1541";"la cisterna";"70 a 74";1341;1780;3121
"1542";"la cisterna";"75 a 79";911;1484;2395
"1543";"la cisterna";"80 a 84";660;1109;1769
"1544";"la cisterna";"85 a 89";372;869;1241
"1545";"la cisterna";"90 a 94";131;371;502
"1546";"la cisterna";"95 a 99";24;107;131
"1547";"la cisterna";"100 o más";11;21;32
"1548";"la florida";"20 a 24";14666;14305;28971
"1549";"la florida";"25 a 29";15783;15324;31107
"1550";"la florida";"30 a 34";13483;13631;27114
"1551";"la florida";"35 a 39";12329;12707;25036
"1552";"la florida";"40 a 44";11965;12765;24730
"1553";"la florida";"45 a 49";10930;12130;23060
"1554";"la florida";"50 a 54";10738;12739;23477
"1555";"la florida";"55 a 59";10307;13137;23444
"1556";"la florida";"60 a 64";9107;11643;20750
"1557";"la florida";"65 a 69";7427;9281;16708
"1558";"la florida";"70 a 74";5571;7307;12878
"1559";"la florida";"75 a 79";3337;4735;8072
"1560";"la florida";"80 a 84";1714;3182;4896
"1561";"la florida";"85 a 89";950;2085;3035
"1562";"la florida";"90 a 94";276;847;1123
"1563";"la florida";"95 a 99";70;208;278
"1564";"la florida";"100 o más";32;68;100
"1565";"la granja";"20 a 24";4981;4785;9766
"1566";"la granja";"25 a 29";5019;4830;9849
"1567";"la granja";"30 a 34";4158;3930;8088
"1568";"la granja";"35 a 39";3555;3394;6949
"1569";"la granja";"40 a 44";3332;3368;6700
"1570";"la granja";"45 a 49";3286;3358;6644
"1571";"la granja";"50 a 54";3830;4405;8235
"1572";"la granja";"55 a 59";4003;4655;8658
"1573";"la granja";"60 a 64";3249;3631;6880
"1574";"la granja";"65 a 69";2338;2525;4863
"1575";"la granja";"70 a 74";1481;1847;3328
"1576";"la granja";"75 a 79";859;1331;2190
"1577";"la granja";"80 a 84";609;1163;1772
"1578";"la granja";"85 a 89";411;834;1245
"1579";"la granja";"90 a 94";109;297;406
"1580";"la granja";"95 a 99";17;53;70
"1581";"la granja";"100 o más";9;27;36
"1582";"la pintana";"20 a 24";7662;7687;15349
"1583";"la pintana";"25 a 29";7551;7376;14927
"1584";"la pintana";"30 a 34";6263;6325;12588
"1585";"la pintana";"35 a 39";5857;5706;11563
"1586";"la pintana";"40 a 44";5642;5539;11181
"1587";"la pintana";"45 a 49";5036;5179;10215
"1588";"la pintana";"50 a 54";5093;5712;10805
"1589";"la pintana";"55 a 59";4822;5447;10269
"1590";"la pintana";"60 a 64";4026;4596;8622
"1591";"la pintana";"65 a 69";3143;3410;6553
"1592";"la pintana";"70 a 74";1971;2516;4487
"1593";"la pintana";"75 a 79";1164;1593;2757
"1594";"la pintana";"80 a 84";526;848;1374
"1595";"la pintana";"85 a 89";257;483;740
"1596";"la pintana";"90 a 94";69;145;214
"1597";"la pintana";"95 a 99";11;55;66
"1598";"la pintana";"100 o más";5;12;17
"1599";"la reina";"20 a 24";3624;3601;7225
"1600";"la reina";"25 a 29";3383;3245;6628
"1601";"la reina";"30 a 34";2601;2761;5362
"1602";"la reina";"35 a 39";2888;3289;6177
"1603";"la reina";"40 a 44";3062;3546;6608
"1604";"la reina";"45 a 49";2844;3462;6306
"1605";"la reina";"50 a 54";2916;3566;6482
"1606";"la reina";"55 a 59";2573;3354;5927
"1607";"la reina";"60 a 64";2132;2840;4972
"1608";"la reina";"65 a 69";1812;2347;4159
"1609";"la reina";"70 a 74";1439;1888;3327
"1610";"la reina";"75 a 79";1010;1480;2490
"1611";"la reina";"80 a 84";648;1091;1739
"1612";"la reina";"85 a 89";439;834;1273
"1613";"la reina";"90 a 94";162;437;599
"1614";"la reina";"95 a 99";39;155;194
"1615";"la reina";"100 o más";11;32;43
"1616";"las condes";"20 a 24";12172;12295;24467
"1617";"las condes";"25 a 29";12858;13142;26000
"1618";"las condes";"30 a 34";11541;12080;23621
"1619";"las condes";"35 a 39";9954;11122;21076
"1620";"las condes";"40 a 44";8973;10592;19565
"1621";"las condes";"45 a 49";8225;10286;18511
"1622";"las condes";"50 a 54";7904;10557;18461
"1623";"las condes";"55 a 59";7714;10392;18106
"1624";"las condes";"60 a 64";6535;9259;15794
"1625";"las condes";"65 a 69";5170;7243;12413
"1626";"las condes";"70 a 74";4520;6645;11165
"1627";"las condes";"75 a 79";3385;5062;8447
"1628";"las condes";"80 a 84";2391;3902;6293
"1629";"las condes";"85 a 89";1541;3112;4653
"1630";"las condes";"90 a 94";661;1545;2206
"1631";"las condes";"95 a 99";161;513;674
"1632";"las condes";"100 o más";25;135;160
"1633";"lo barnechea";"20 a 24";4661;4787;9448
"1634";"lo barnechea";"25 a 29";3721;3405;7126
"1635";"lo barnechea";"30 a 34";2486;2813;5299
"1636";"lo barnechea";"35 a 39";3055;3796;6851
"1637";"lo barnechea";"40 a 44";3475;4453;7928
"1638";"lo barnechea";"45 a 49";3580;4634;8214
"1639";"lo barnechea";"50 a 54";3608;4286;7894
"1640";"lo barnechea";"55 a 59";2938;3517;6455
"1641";"lo barnechea";"60 a 64";2155;2423;4578
"1642";"lo barnechea";"65 a 69";1394;1538;2932
"1643";"lo barnechea";"70 a 74";987;1122;2109
"1644";"lo barnechea";"75 a 79";517;700;1217
"1645";"lo barnechea";"80 a 84";362;473;835
"1646";"lo barnechea";"85 a 89";192;353;545
"1647";"lo barnechea";"90 a 94";64;193;257
"1648";"lo barnechea";"95 a 99";23;76;99
"1649";"lo barnechea";"100 o más";8;24;32
"1650";"lo espejo";"20 a 24";4356;4279;8635
"1651";"lo espejo";"25 a 29";4637;4205;8842
"1652";"lo espejo";"30 a 34";3473;3132;6605
"1653";"lo espejo";"35 a 39";3006;2728;5734
"1654";"lo espejo";"40 a 44";2870;2634;5504
"1655";"lo espejo";"45 a 49";2972;2992;5964
"1656";"lo espejo";"50 a 54";3539;3605;7144
"1657";"lo espejo";"55 a 59";3566;3635;7201
"1658";"lo espejo";"60 a 64";2507;2633;5140
"1659";"lo espejo";"65 a 69";1624;1905;3529
"1660";"lo espejo";"70 a 74";1191;1490;2681
"1661";"lo espejo";"75 a 79";774;1272;2046
"1662";"lo espejo";"80 a 84";579;1056;1635
"1663";"lo espejo";"85 a 89";381;795;1176
"1664";"lo espejo";"90 a 94";123;274;397
"1665";"lo espejo";"95 a 99";20;65;85
"1666";"lo espejo";"100 o más";5;12;17
"1667";"lo prado";"20 a 24";4144;3946;8090
"1668";"lo prado";"25 a 29";4238;3951;8189
"1669";"lo prado";"30 a 34";3435;3034;6469
"1670";"lo prado";"35 a 39";2957;2860;5817
"1671";"lo prado";"40 a 44";3271;3350;6621
"1672";"lo prado";"45 a 49";3219;3453;6672
"1673";"lo prado";"50 a 54";3185;3384;6569
"1674";"lo prado";"55 a 59";2563;2893;5456
"1675";"lo prado";"60 a 64";2000;2418;4418
"1676";"lo prado";"65 a 69";1805;2389;4194
"1677";"lo prado";"70 a 74";1681;2280;3961
"1678";"lo prado";"75 a 79";1196;1653;2849
"1679";"lo prado";"80 a 84";615;1073;1688
"1680";"lo prado";"85 a 89";292;606;898
"1681";"lo prado";"90 a 94";85;232;317
"1682";"lo prado";"95 a 99";17;57;74
"1683";"lo prado";"100 o más";9;18;27
"1684";"macul";"20 a 24";4552;4476;9028
"1685";"macul";"25 a 29";5225;5236;10461
"1686";"macul";"30 a 34";4712;4645;9357
"1687";"macul";"35 a 39";4121;4263;8384
"1688";"macul";"40 a 44";3739;3949;7688
"1689";"macul";"45 a 49";3520;3779;7299
"1690";"macul";"50 a 54";3418;4072;7490
"1691";"macul";"55 a 59";3137;3982;7119
"1692";"macul";"60 a 64";2529;3427;5956
"1693";"macul";"65 a 69";2090;2882;4972
"1694";"macul";"70 a 74";1772;2572;4344
"1695";"macul";"75 a 79";1262;1988;3250
"1696";"macul";"80 a 84";801;1378;2179
"1697";"macul";"85 a 89";471;1124;1595
"1698";"macul";"90 a 94";163;415;578
"1699";"macul";"95 a 99";46;138;184
"1700";"macul";"100 o más";7;19;26
"1701";"maipú";"20 a 24";23063;21989;45052
"1702";"maipú";"25 a 29";22469;21849;44318
"1703";"maipú";"30 a 34";18096;18197;36293
"1704";"maipú";"35 a 39";15949;17134;33083
"1705";"maipú";"40 a 44";16003;17939;33942
"1706";"maipú";"45 a 49";16237;19299;35536
"1707";"maipú";"50 a 54";18112;22278;40390
"1708";"maipú";"55 a 59";16771;19957;36728
"1709";"maipú";"60 a 64";12032;14397;26429
"1710";"maipú";"65 a 69";8242;10090;18332
"1711";"maipú";"70 a 74";5609;7352;12961
"1712";"maipú";"75 a 79";3254;4813;8067
"1713";"maipú";"80 a 84";1737;3225;4962
"1714";"maipú";"85 a 89";890;2222;3112
"1715";"maipú";"90 a 94";281;863;1144
"1716";"maipú";"95 a 99";57;245;302
"1717";"maipú";"100 o más";43;87;130
"1718";"ñuñoa";"20 a 24";6836;6893;13729
"1719";"ñuñoa";"25 a 29";8944;9712;18656
"1720";"ñuñoa";"30 a 34";10557;11378;21935
"1721";"ñuñoa";"35 a 39";9465;9999;19464
"1722";"ñuñoa";"40 a 44";7354;8087;15441
"1723";"ñuñoa";"45 a 49";5696;6654;12350
"1724";"ñuñoa";"50 a 54";5427;6789;12216
"1725";"ñuñoa";"55 a 59";5228;6901;12129
"1726";"ñuñoa";"60 a 64";4160;6202;10362
"1727";"ñuñoa";"65 a 69";3258;5011;8269
"1728";"ñuñoa";"70 a 74";2586;4334;6920
"1729";"ñuñoa";"75 a 79";1920;3363;5283
"1730";"ñuñoa";"80 a 84";1384;2917;4301
"1731";"ñuñoa";"85 a 89";1029;2427;3456
"1732";"ñuñoa";"90 a 94";433;1169;1602
"1733";"ñuñoa";"95 a 99";89;386;475
"1734";"ñuñoa";"100 o más";21;82;103
"1735";"pedro aguirre cerda";"20 a 24";4241;3974;8215
"1736";"pedro aguirre cerda";"25 a 29";4491;4129;8620
"1737";"pedro aguirre cerda";"30 a 34";3642;3356;6998
"1738";"pedro aguirre cerda";"35 a 39";3094;2926;6020
"1739";"pedro aguirre cerda";"40 a 44";2858;2800;5658
"1740";"pedro aguirre cerda";"45 a 49";2854;2970;5824
"1741";"pedro aguirre cerda";"50 a 54";3565;3779;7344
"1742";"pedro aguirre cerda";"55 a 59";3570;3924;7494
"1743";"pedro aguirre cerda";"60 a 64";2875;3149;6024
"1744";"pedro aguirre cerda";"65 a 69";1915;2425;4340
"1745";"pedro aguirre cerda";"70 a 74";1384;1835;3219
"1746";"pedro aguirre cerda";"75 a 79";978;1467;2445
"1747";"pedro aguirre cerda";"80 a 84";678;1346;2024
"1748";"pedro aguirre cerda";"85 a 89";514;1033;1547
"1749";"pedro aguirre cerda";"90 a 94";185;440;625
"1750";"pedro aguirre cerda";"95 a 99";40;111;151
"1751";"pedro aguirre cerda";"100 o más";8;21;29
"1752";"peñalolén";"20 a 24";10766;10362;21128
"1753";"peñalolén";"25 a 29";9712;9372;19084
"1754";"peñalolén";"30 a 34";7330;7457;14787
"1755";"peñalolén";"35 a 39";7525;8111;15636
"1756";"peñalolén";"40 a 44";8505;9425;17930
"1757";"peñalolén";"45 a 49";8687;9469;18156
"1758";"peñalolén";"50 a 54";8216;9141;17357
"1759";"peñalolén";"55 a 59";6521;7299;13820
"1760";"peñalolén";"60 a 64";5026;5793;10819
"1761";"peñalolén";"65 a 69";3902;4625;8527
"1762";"peñalolén";"70 a 74";2922;3927;6849
"1763";"peñalolén";"75 a 79";1853;2771;4624
"1764";"peñalolén";"80 a 84";961;1710;2671
"1765";"peñalolén";"85 a 89";463;1032;1495
"1766";"peñalolén";"90 a 94";166;399;565
"1767";"peñalolén";"95 a 99";33;91;124
"1768";"peñalolén";"100 o más";23;44;67
"1769";"providencia";"20 a 24";4899;5177;10076
"1770";"providencia";"25 a 29";7115;7739;14854
"1771";"providencia";"30 a 34";8259;8524;16783
"1772";"providencia";"35 a 39";7002;7219;14221
"1773";"providencia";"40 a 44";5346;5502;10848
"1774";"providencia";"45 a 49";3902;4220;8122
"1775";"providencia";"50 a 54";3308;3918;7226
"1776";"providencia";"55 a 59";3049;4140;7189
"1777";"providencia";"60 a 64";2694;4035;6729
"1778";"providencia";"65 a 69";2389;3471;5860
"1779";"providencia";"70 a 74";1988;3119;5107
"1780";"providencia";"75 a 79";1414;2334;3748
"1781";"providencia";"80 a 84";1043;2067;3110
"1782";"providencia";"85 a 89";754;1755;2509
"1783";"providencia";"90 a 94";349;1051;1400
"1784";"providencia";"95 a 99";93;335;428
"1785";"providencia";"100 o más";20;81;101
"1786";"pudahuel";"20 a 24";10186;9778;19964
"1787";"pudahuel";"25 a 29";10163;9949;20112
"1788";"pudahuel";"30 a 34";8083;8286;16369
"1789";"pudahuel";"35 a 39";7635;8049;15684
"1790";"pudahuel";"40 a 44";7927;8190;16117
"1791";"pudahuel";"45 a 49";7474;8269;15743
"1792";"pudahuel";"50 a 54";8060;9132;17192
"1793";"pudahuel";"55 a 59";6833;7627;14460
"1794";"pudahuel";"60 a 64";4783;5531;10314
"1795";"pudahuel";"65 a 69";3190;3899;7089
"1796";"pudahuel";"70 a 74";2222;2977;5199
"1797";"pudahuel";"75 a 79";1425;2052;3477
"1798";"pudahuel";"80 a 84";732;1323;2055
"1799";"pudahuel";"85 a 89";344;833;1177
"1800";"pudahuel";"90 a 94";112;286;398
"1801";"pudahuel";"95 a 99";21;80;101
"1802";"pudahuel";"100 o más";23;19;42
"1803";"quilicura";"20 a 24";9406;9219;18625
"1804";"quilicura";"25 a 29";9483;9023;18506
"1805";"quilicura";"30 a 34";7886;7780;15666
"1806";"quilicura";"35 a 39";7394;7878;15272
"1807";"quilicura";"40 a 44";7906;8753;16659
"1808";"quilicura";"45 a 49";7723;8237;15960
"1809";"quilicura";"50 a 54";6849;7508;14357
"1810";"quilicura";"55 a 59";5246;5757;11003
"1811";"quilicura";"60 a 64";3576;3947;7523
"1812";"quilicura";"65 a 69";2048;2648;4696
"1813";"quilicura";"70 a 74";1308;1698;3006
"1814";"quilicura";"75 a 79";693;1084;1777
"1815";"quilicura";"80 a 84";354;688;1042
"1816";"quilicura";"85 a 89";204;401;605
"1817";"quilicura";"90 a 94";63;161;224
"1818";"quilicura";"95 a 99";12;38;50
"1819";"quilicura";"100 o más";21;23;44
"1820";"quinta normal";"20 a 24";4797;4483;9280
"1821";"quinta normal";"25 a 29";5218;4993;10211
"1822";"quinta normal";"30 a 34";4528;4148;8676
"1823";"quinta normal";"35 a 39";3736;3753;7489
"1824";"quinta normal";"40 a 44";3747;3865;7612
"1825";"quinta normal";"45 a 49";3373;3514;6887
"1826";"quinta normal";"50 a 54";3493;3911;7404
"1827";"quinta normal";"55 a 59";3035;3468;6503
"1828";"quinta normal";"60 a 64";2394;2802;5196
"1829";"quinta normal";"65 a 69";1970;2374;4344
"1830";"quinta normal";"70 a 74";1563;1936;3499
"1831";"quinta normal";"75 a 79";1038;1593;2631
"1832";"quinta normal";"80 a 84";646;1199;1845
"1833";"quinta normal";"85 a 89";396;912;1308
"1834";"quinta normal";"90 a 94";126;347;473
"1835";"quinta normal";"95 a 99";34;95;129
"1836";"quinta normal";"100 o más";13;36;49
"1837";"recoleta";"20 a 24";7042;6430;13472
"1838";"recoleta";"25 a 29";7428;6894;14322
"1839";"recoleta";"30 a 34";6459;5935;12394
"1840";"recoleta";"35 a 39";5864;5529;11393
"1841";"recoleta";"40 a 44";5541;5446;10987
"1842";"recoleta";"45 a 49";5012;5100;10112
"1843";"recoleta";"50 a 54";4864;5162;10026
"1844";"recoleta";"55 a 59";4211;4733;8944
"1845";"recoleta";"60 a 64";3551;4031;7582
"1846";"recoleta";"65 a 69";2805;3484;6289
"1847";"recoleta";"70 a 74";2257;2884;5141
"1848";"recoleta";"75 a 79";1472;2250;3722
"1849";"recoleta";"80 a 84";819;1500;2319
"1850";"recoleta";"85 a 89";457;1120;1577
"1851";"recoleta";"90 a 94";145;417;562
"1852";"recoleta";"95 a 99";35;121;156
"1853";"recoleta";"100 o más";13;36;49
"1854";"renca";"20 a 24";6260;6013;12273
"1855";"renca";"25 a 29";6227;5877;12104
"1856";"renca";"30 a 34";5328;5209;10537
"1857";"renca";"35 a 39";5192;5256;10448
"1858";"renca";"40 a 44";5262;5261;10523
"1859";"renca";"45 a 49";4701;4715;9416
"1860";"renca";"50 a 54";4393;4680;9073
"1861";"renca";"55 a 59";3752;4252;8004
"1862";"renca";"60 a 64";3090;3623;6713
"1863";"renca";"65 a 69";2378;2886;5264
"1864";"renca";"70 a 74";1822;2243;4065
"1865";"renca";"75 a 79";1036;1511;2547
"1866";"renca";"80 a 84";570;920;1490
"1867";"renca";"85 a 89";303;616;919
"1868";"renca";"90 a 94";95;241;336
"1869";"renca";"95 a 99";18;53;71
"1870";"renca";"100 o más";14;30;44
"1871";"san joaquín";"20 a 24";3932;3931;7863
"1872";"san joaquín";"25 a 29";4244;4096;8340
"1873";"san joaquín";"30 a 34";3456;3322;6778
"1874";"san joaquín";"35 a 39";2956;2880;5836
"1875";"san joaquín";"40 a 44";2747;2871;5618
"1876";"san joaquín";"45 a 49";2867;3061;5928
"1877";"san joaquín";"50 a 54";3199;3416;6615
"1878";"san joaquín";"55 a 59";2844;3199;6043
"1879";"san joaquín";"60 a 64";2263;2676;4939
"1880";"san joaquín";"65 a 69";1813;2270;4083
"1881";"san joaquín";"70 a 74";1547;2019;3566
"1882";"san joaquín";"75 a 79";1037;1587;2624
"1883";"san joaquín";"80 a 84";666;1132;1798
"1884";"san joaquín";"85 a 89";393;921;1314
"1885";"san joaquín";"90 a 94";126;317;443
"1886";"san joaquín";"95 a 99";26;99;125
"1887";"san joaquín";"100 o más";10;23;33
"1888";"san miguel";"20 a 24";3915;4028;7943
"1889";"san miguel";"25 a 29";5068;5572;10640
"1890";"san miguel";"30 a 34";5392;5415;10807
"1891";"san miguel";"35 a 39";4339;4523;8862
"1892";"san miguel";"40 a 44";3614;3860;7474
"1893";"san miguel";"45 a 49";3114;3437;6551
"1894";"san miguel";"50 a 54";3022;3579;6601
"1895";"san miguel";"55 a 59";2875;3568;6443
"1896";"san miguel";"60 a 64";2167;2842;5009
"1897";"san miguel";"65 a 69";1688;2237;3925
"1898";"san miguel";"70 a 74";1314;1925;3239
"1899";"san miguel";"75 a 79";964;1572;2536
"1900";"san miguel";"80 a 84";626;1245;1871
"1901";"san miguel";"85 a 89";415;1025;1440
"1902";"san miguel";"90 a 94";119;436;555
"1903";"san miguel";"95 a 99";33;141;174
"1904";"san miguel";"100 o más";18;33;51
"1905";"san ramón";"20 a 24";3641;3425;7066
"1906";"san ramón";"25 a 29";3414;3222;6636
"1907";"san ramón";"30 a 34";2568;2462;5030
"1908";"san ramón";"35 a 39";2400;2305;4705
"1909";"san ramón";"40 a 44";2699;2680;5379
"1910";"san ramón";"45 a 49";2992;2826;5818
"1911";"san ramón";"50 a 54";2865;3003;5868
"1912";"san ramón";"55 a 59";2262;2350;4612
"1913";"san ramón";"60 a 64";1850;2035;3885
"1914";"san ramón";"65 a 69";1524;2069;3593
"1915";"san ramón";"70 a 74";1513;1946;3459
"1916";"san ramón";"75 a 79";973;1423;2396
"1917";"san ramón";"80 a 84";604;921;1525
"1918";"san ramón";"85 a 89";264;497;761
"1919";"san ramón";"90 a 94";90;202;292
"1920";"san ramón";"95 a 99";14;54;68
"1921";"san ramón";"100 o más";8;10;18
"1922";"vitacura";"20 a 24";2798;2961;5759
"1923";"vitacura";"25 a 29";2653;2857;5510
"1924";"vitacura";"30 a 34";2567;2993;5560
"1925";"vitacura";"35 a 39";2752;3231;5983
"1926";"vitacura";"40 a 44";2581;3262;5843
"1927";"vitacura";"45 a 49";2351;3292;5643
"1928";"vitacura";"50 a 54";2159;3113;5272
"1929";"vitacura";"55 a 59";2050;3081;5131
"1930";"vitacura";"60 a 64";1796;2720;4516
"1931";"vitacura";"65 a 69";1595;2433;4028
"1932";"vitacura";"70 a 74";1609;2313;3922
"1933";"vitacura";"75 a 79";1261;1605;2866
"1934";"vitacura";"80 a 84";792;1124;1916
"1935";"vitacura";"85 a 89";536;841;1377
"1936";"vitacura";"90 a 94";208;473;681
"1937";"vitacura";"95 a 99";44;155;199
"1938";"vitacura";"100 o más";11;33;44
"1939";"puente alto";"20 a 24";25268;24443;49711
"1940";"puente alto";"25 a 29";24777;24250;49027
"1941";"puente alto";"30 a 34";20048;20676;40724
"1942";"puente alto";"35 a 39";18318;19377;37695
"1943";"puente alto";"40 a 44";17933;19654;37587
"1944";"puente alto";"45 a 49";17620;20645;38265
"1945";"puente alto";"50 a 54";19167;23020;42187
"1946";"puente alto";"55 a 59";17139;19642;36781
"1947";"puente alto";"60 a 64";12032;13766;25798
"1948";"puente alto";"65 a 69";7638;9088;16726
"1949";"puente alto";"70 a 74";4788;6401;11189
"1950";"puente alto";"75 a 79";2710;4311;7021
"1951";"puente alto";"80 a 84";1551;2878;4429
"1952";"puente alto";"85 a 89";833;1952;2785
"1953";"puente alto";"90 a 94";245;727;972
"1954";"puente alto";"95 a 99";76;200;276
"1955";"puente alto";"100 o más";30;60;90
"1956";"pirque";"20 a 24";1056;1020;2076
"1957";"pirque";"25 a 29";1108;1027;2135
"1958";"pirque";"30 a 34";890;875;1765
"1959";"pirque";"35 a 39";861;878;1739
"1960";"pirque";"40 a 44";890;916;1806
"1961";"pirque";"45 a 49";906;938;1844
"1962";"pirque";"50 a 54";1024;1029;2053
"1963";"pirque";"55 a 59";886;806;1692
"1964";"pirque";"60 a 64";678;625;1303
"1965";"pirque";"65 a 69";484;457;941
"1966";"pirque";"70 a 74";383;324;707
"1967";"pirque";"75 a 79";228;226;454
"1968";"pirque";"80 a 84";116;178;294
"1969";"pirque";"85 a 89";81;103;184
"1970";"pirque";"90 a 94";30;48;78
"1971";"pirque";"95 a 99";3;9;12
"1972";"pirque";"100 o más";4;3;7
"1973";"san josé de maipo";"20 a 24";672;630;1302
"1974";"san josé de maipo";"25 a 29";832;659;1491
"1975";"san josé de maipo";"30 a 34";814;553;1367
"1976";"san josé de maipo";"35 a 39";837;606;1443
"1977";"san josé de maipo";"40 a 44";854;581;1435
"1978";"san josé de maipo";"45 a 49";799;581;1380
"1979";"san josé de maipo";"50 a 54";744;554;1298
"1980";"san josé de maipo";"55 a 59";627;536;1163
"1981";"san josé de maipo";"60 a 64";487;450;937
"1982";"san josé de maipo";"65 a 69";317;328;645
"1983";"san josé de maipo";"70 a 74";269;274;543
"1984";"san josé de maipo";"75 a 79";145;205;350
"1985";"san josé de maipo";"80 a 84";112;125;237
"1986";"san josé de maipo";"85 a 89";59;100;159
"1987";"san josé de maipo";"90 a 94";18;33;51
"1988";"san josé de maipo";"95 a 99";1;12;13
"1989";"san josé de maipo";"100 o más";1;4;5
"1990";"colina";"20 a 24";6027;5037;11064
"1991";"colina";"25 a 29";5924;5052;10976
"1992";"colina";"30 a 34";5612;5194;10806
"1993";"colina";"35 a 39";6257;6339;12596
"1994";"colina";"40 a 44";6223;6179;12402
"1995";"colina";"45 a 49";5282;5131;10413
"1996";"colina";"50 a 54";4279;4201;8480
"1997";"colina";"55 a 59";3160;3223;6383
"1998";"colina";"60 a 64";2390;2451;4841
"1999";"colina";"65 a 69";1695;1732;3427
"2000";"colina";"70 a 74";1120;1253;2373
"2001";"colina";"75 a 79";632;778;1410
"2002";"colina";"80 a 84";348;469;817
"2003";"colina";"85 a 89";167;286;453
"2004";"colina";"90 a 94";55;115;170
"2005";"colina";"95 a 99";20;35;55
"2006";"colina";"100 o más";9;7;16
"2007";"lampa";"20 a 24";3841;3777;7618
"2008";"lampa";"25 a 29";4299;4387;8686
"2009";"lampa";"30 a 34";4476;4555;9031
"2010";"lampa";"35 a 39";4283;4464;8747
"2011";"lampa";"40 a 44";4001;3864;7865
"2012";"lampa";"45 a 49";3364;3094;6458
"2013";"lampa";"50 a 54";2889;2686;5575
"2014";"lampa";"55 a 59";2238;2201;4439
"2015";"lampa";"60 a 64";1656;1588;3244
"2016";"lampa";"65 a 69";1089;1146;2235
"2017";"lampa";"70 a 74";762;790;1552
"2018";"lampa";"75 a 79";481;508;989
"2019";"lampa";"80 a 84";276;341;617
"2020";"lampa";"85 a 89";143;217;360
"2021";"lampa";"90 a 94";51;91;142
"2022";"lampa";"95 a 99";18;24;42
"2023";"lampa";"100 o más";6;8;14
"2024";"tiltil";"20 a 24";859;725;1584
"2025";"tiltil";"25 a 29";840;783;1623
"2026";"tiltil";"30 a 34";732;699;1431
"2027";"tiltil";"35 a 39";666;634;1300
"2028";"tiltil";"40 a 44";690;668;1358
"2029";"tiltil";"45 a 49";668;603;1271
"2030";"tiltil";"50 a 54";673;638;1311
"2031";"tiltil";"55 a 59";570;505;1075
"2032";"tiltil";"60 a 64";409;413;822
"2033";"tiltil";"65 a 69";384;330;714
"2034";"tiltil";"70 a 74";284;242;526
"2035";"tiltil";"75 a 79";182;177;359
"2036";"tiltil";"80 a 84";114;121;235
"2037";"tiltil";"85 a 89";56;70;126
"2038";"tiltil";"90 a 94";12;26;38
"2039";"tiltil";"95 a 99";4;5;9
"2040";"tiltil";"100 o más";1;1;2
"2041";"san bernardo";"20 a 24";13081;12393;25474
"2042";"san bernardo";"25 a 29";12728;12594;25322
"2043";"san bernardo";"30 a 34";10870;11064;21934
"2044";"san bernardo";"35 a 39";10205;10414;20619
"2045";"san bernardo";"40 a 44";10146;10472;20618
"2046";"san bernardo";"45 a 49";9716;10524;20240
"2047";"san bernardo";"50 a 54";8991;10040;19031
"2048";"san bernardo";"55 a 59";7930;8780;16710
"2049";"san bernardo";"60 a 64";6015;6784;12799
"2050";"san bernardo";"65 a 69";4351;5109;9460
"2051";"san bernardo";"70 a 74";3103;3840;6943
"2052";"san bernardo";"75 a 79";1832;2557;4389
"2053";"san bernardo";"80 a 84";1054;1737;2791
"2054";"san bernardo";"85 a 89";573;1167;1740
"2055";"san bernardo";"90 a 94";164;439;603
"2056";"san bernardo";"95 a 99";49;113;162
"2057";"san bernardo";"100 o más";14;21;35
"2058";"buin";"20 a 24";3718;3633;7351
"2059";"buin";"25 a 29";4106;4259;8365
"2060";"buin";"30 a 34";3822;3989;7811
"2061";"buin";"35 a 39";3617;3741;7358
"2062";"buin";"40 a 44";3317;3440;6757
"2063";"buin";"45 a 49";3108;3305;6413
"2064";"buin";"50 a 54";3006;3114;6120
"2065";"buin";"55 a 59";2636;2720;5356
"2066";"buin";"60 a 64";1881;2013;3894
"2067";"buin";"65 a 69";1335;1560;2895
"2068";"buin";"70 a 74";994;1231;2225
"2069";"buin";"75 a 79";658;802;1460
"2070";"buin";"80 a 84";422;560;982
"2071";"buin";"85 a 89";207;373;580
"2072";"buin";"90 a 94";83;141;224
"2073";"buin";"95 a 99";13;52;65
"2074";"buin";"100 o más";10;12;22
"2075";"calera de tango";"20 a 24";1132;1019;2151
"2076";"calera de tango";"25 a 29";1044;1004;2048
"2077";"calera de tango";"30 a 34";779;794;1573
"2078";"calera de tango";"35 a 39";796;833;1629
"2079";"calera de tango";"40 a 44";930;926;1856
"2080";"calera de tango";"45 a 49";858;905;1763
"2081";"calera de tango";"50 a 54";881;991;1872
"2082";"calera de tango";"55 a 59";800;836;1636
"2083";"calera de tango";"60 a 64";621;588;1209
"2084";"calera de tango";"65 a 69";456;415;871
"2085";"calera de tango";"70 a 74";322;309;631
"2086";"calera de tango";"75 a 79";169;211;380
"2087";"calera de tango";"80 a 84";117;138;255
"2088";"calera de tango";"85 a 89";62;109;171
"2089";"calera de tango";"90 a 94";17;39;56
"2090";"calera de tango";"95 a 99";4;16;20
"2091";"calera de tango";"100 o más";4;4;8
"2092";"paine";"20 a 24";2947;2823;5770
"2093";"paine";"25 a 29";2906;2913;5819
"2094";"paine";"30 a 34";2584;2515;5099
"2095";"paine";"35 a 39";2588;2564;5152
"2096";"paine";"40 a 44";2500;2498;4998
"2097";"paine";"45 a 49";2474;2490;4964
"2098";"paine";"50 a 54";2497;2527;5024
"2099";"paine";"55 a 59";2115;2068;4183
"2100";"paine";"60 a 64";1625;1670;3295
"2101";"paine";"65 a 69";1328;1296;2624
"2102";"paine";"70 a 74";937;895;1832
"2103";"paine";"75 a 79";577;620;1197
"2104";"paine";"80 a 84";311;393;704
"2105";"paine";"85 a 89";203;287;490
"2106";"paine";"90 a 94";63;109;172
"2107";"paine";"95 a 99";15;35;50
"2108";"paine";"100 o más";5;10;15
"2109";"melipilla";"20 a 24";4746;4752;9498
"2110";"melipilla";"25 a 29";5030;4932;9962
"2111";"melipilla";"30 a 34";4474;4452;8926
"2112";"melipilla";"35 a 39";4225;4238;8463
"2113";"melipilla";"40 a 44";4012;4205;8217
"2114";"melipilla";"45 a 49";3902;3956;7858
"2115";"melipilla";"50 a 54";4009;4169;8178
"2116";"melipilla";"55 a 59";3644;3852;7496
"2117";"melipilla";"60 a 64";2858;2977;5835
"2118";"melipilla";"65 a 69";2245;2467;4712
"2119";"melipilla";"70 a 74";1788;1872;3660
"2120";"melipilla";"75 a 79";1230;1423;2653
"2121";"melipilla";"80 a 84";792;883;1675
"2122";"melipilla";"85 a 89";423;597;1020
"2123";"melipilla";"90 a 94";156;257;413
"2124";"melipilla";"95 a 99";23;85;108
"2125";"melipilla";"100 o más";11;11;22
"2126";"alhué";"20 a 24";256;216;472
"2127";"alhué";"25 a 29";318;282;600
"2128";"alhué";"30 a 34";289;242;531
"2129";"alhué";"35 a 39";264;216;480
"2130";"alhué";"40 a 44";381;166;547
"2131";"alhué";"45 a 49";241;199;440
"2132";"alhué";"50 a 54";251;204;455
"2133";"alhué";"55 a 59";196;173;369
"2134";"alhué";"60 a 64";167;119;286
"2135";"alhué";"65 a 69";128;116;244
"2136";"alhué";"70 a 74";82;86;168
"2137";"alhué";"75 a 79";56;59;115
"2138";"alhué";"80 a 84";47;51;98
"2139";"alhué";"85 a 89";31;32;63
"2140";"alhué";"90 a 94";6;12;18
"2141";"alhué";"95 a 99";2;2;4
"2142";"alhué";"100 o más";0;2;2
"2143";"curacaví";"20 a 24";1272;1236;2508
"2144";"curacaví";"25 a 29";1327;1199;2526
"2145";"curacaví";"30 a 34";1095;1179;2274
"2146";"curacaví";"35 a 39";1095;1099;2194
"2147";"curacaví";"40 a 44";1038;1046;2084
"2148";"curacaví";"45 a 49";1012;1121;2133
"2149";"curacaví";"50 a 54";1142;1177;2319
"2150";"curacaví";"55 a 59";1045;1058;2103
"2151";"curacaví";"60 a 64";777;833;1610
"2152";"curacaví";"65 a 69";635;632;1267
"2153";"curacaví";"70 a 74";494;539;1033
"2154";"curacaví";"75 a 79";355;377;732
"2155";"curacaví";"80 a 84";228;244;472
"2156";"curacaví";"85 a 89";99;142;241
"2157";"curacaví";"90 a 94";32;60;92
"2158";"curacaví";"95 a 99";9;14;23
"2159";"curacaví";"100 o más";5;4;9
"2160";"maría pinto";"20 a 24";496;515;1011
"2161";"maría pinto";"25 a 29";586;516;1102
"2162";"maría pinto";"30 a 34";470;489;959
"2163";"maría pinto";"35 a 39";454;467;921
"2164";"maría pinto";"40 a 44";464;427;891
"2165";"maría pinto";"45 a 49";479;458;937
"2166";"maría pinto";"50 a 54";489;498;987
"2167";"maría pinto";"55 a 59";407;407;814
"2168";"maría pinto";"60 a 64";327;359;686
"2169";"maría pinto";"65 a 69";261;233;494
"2170";"maría pinto";"70 a 74";214;196;410
"2171";"maría pinto";"75 a 79";133;154;287
"2172";"maría pinto";"80 a 84";92;101;193
"2173";"maría pinto";"85 a 89";63;50;113
"2174";"maría pinto";"90 a 94";21;24;45
"2175";"maría pinto";"95 a 99";5;8;13
"2176";"maría pinto";"100 o más";3;1;4
"2177";"san pedro";"20 a 24";332;274;606
"2178";"san pedro";"25 a 29";388;336;724
"2179";"san pedro";"30 a 34";366;332;698
"2180";"san pedro";"35 a 39";338;287;625
"2181";"san pedro";"40 a 44";319;289;608
"2182";"san pedro";"45 a 49";320;287;607
"2183";"san pedro";"50 a 54";360;292;652
"2184";"san pedro";"55 a 59";357;278;635
"2185";"san pedro";"60 a 64";294;242;536
"2186";"san pedro";"65 a 69";243;197;440
"2187";"san pedro";"70 a 74";189;160;349
"2188";"san pedro";"75 a 79";152;124;276
"2189";"san pedro";"80 a 84";88;83;171
"2190";"san pedro";"85 a 89";48;59;107
"2191";"san pedro";"90 a 94";13;23;36
"2192";"san pedro";"95 a 99";4;5;9
"2193";"san pedro";"100 o más";2;0;2
"2194";"talagante";"20 a 24";3145;2888;6033
"2195";"talagante";"25 a 29";3074;2998;6072
"2196";"talagante";"30 a 34";2690;2560;5250
"2197";"talagante";"35 a 39";2501;2511;5012
"2198";"talagante";"40 a 44";2464;2504;4968
"2199";"talagante";"45 a 49";2436;2558;4994
"2200";"talagante";"50 a 54";2485;2803;5288
"2201";"talagante";"55 a 59";2274;2325;4599
"2202";"talagante";"60 a 64";1574;1750;3324
"2203";"talagante";"65 a 69";1146;1326;2472
"2204";"talagante";"70 a 74";818;1041;1859
"2205";"talagante";"75 a 79";566;724;1290
"2206";"talagante";"80 a 84";334;474;808
"2207";"talagante";"85 a 89";193;314;507
"2208";"talagante";"90 a 94";58;121;179
"2209";"talagante";"95 a 99";9;36;45
"2210";"talagante";"100 o más";11;11;22
"2211";"el monte";"20 a 24";1500;1376;2876
"2212";"el monte";"25 a 29";1488;1497;2985
"2213";"el monte";"30 a 34";1276;1337;2613
"2214";"el monte";"35 a 39";1169;1166;2335
"2215";"el monte";"40 a 44";1169;1188;2357
"2216";"el monte";"45 a 49";1133;1179;2312
"2217";"el monte";"50 a 54";1226;1205;2431
"2218";"el monte";"55 a 59";1007;1089;2096
"2219";"el monte";"60 a 64";790;761;1551
"2220";"el monte";"65 a 69";570;650;1220
"2221";"el monte";"70 a 74";453;501;954
"2222";"el monte";"75 a 79";303;359;662
"2223";"el monte";"80 a 84";184;258;442
"2224";"el monte";"85 a 89";93;140;233
"2225";"el monte";"90 a 94";34;71;105
"2226";"el monte";"95 a 99";4;28;32
"2227";"el monte";"100 o más";2;4;6
"2228";"isla de maipo";"20 a 24";1432;1400;2832
"2229";"isla de maipo";"25 a 29";1383;1422;2805
"2230";"isla de maipo";"30 a 34";1252;1265;2517
"2231";"isla de maipo";"35 a 39";1184;1230;2414
"2232";"isla de maipo";"40 a 44";1267;1263;2530
"2233";"isla de maipo";"45 a 49";1165;1262;2427
"2234";"isla de maipo";"50 a 54";1307;1257;2564
"2235";"isla de maipo";"55 a 59";1058;1094;2152
"2236";"isla de maipo";"60 a 64";835;799;1634
"2237";"isla de maipo";"65 a 69";595;649;1244
"2238";"isla de maipo";"70 a 74";493;521;1014
"2239";"isla de maipo";"75 a 79";314;311;625
"2240";"isla de maipo";"80 a 84";183;229;412
"2241";"isla de maipo";"85 a 89";104;145;249
"2242";"isla de maipo";"90 a 94";45;72;117
"2243";"isla de maipo";"95 a 99";11;18;29
"2244";"isla de maipo";"100 o más";2;5;7
"2245";"padre hurtado";"20 a 24";2481;2474;4955
"2246";"padre hurtado";"25 a 29";2718;2773;5491
"2247";"padre hurtado";"30 a 34";2543;2594;5137
"2248";"padre hurtado";"35 a 39";2305;2274;4579
"2249";"padre hurtado";"40 a 44";2274;2197;4471
"2250";"padre hurtado";"45 a 49";1993;2059;4052
"2251";"padre hurtado";"50 a 54";2054;2189;4243
"2252";"padre hurtado";"55 a 59";1624;1695;3319
"2253";"padre hurtado";"60 a 64";1227;1348;2575
"2254";"padre hurtado";"65 a 69";960;1060;2020
"2255";"padre hurtado";"70 a 74";654;802;1456
"2256";"padre hurtado";"75 a 79";503;508;1011
"2257";"padre hurtado";"80 a 84";238;357;595
"2258";"padre hurtado";"85 a 89";140;204;344
"2259";"padre hurtado";"90 a 94";34;79;113
"2260";"padre hurtado";"95 a 99";10;22;32
"2261";"padre hurtado";"100 o más";8;17;25
"2262";"peñaflor";"20 a 24";3681;3599;7280
"2263";"peñaflor";"25 a 29";3498;3564;7062
"2264";"peñaflor";"30 a 34";2888;3067;5955
"2265";"peñaflor";"35 a 39";2899;3177;6076
"2266";"peñaflor";"40 a 44";3241;3536;6777
"2267";"peñaflor";"45 a 49";3203;3218;6421
"2268";"peñaflor";"50 a 54";2850;3185;6035
"2269";"peñaflor";"55 a 59";2383;2681;5064
"2270";"peñaflor";"60 a 64";1758;2118;3876
"2271";"peñaflor";"65 a 69";1442;1632;3074
"2272";"peñaflor";"70 a 74";1057;1301;2358
"2273";"peñaflor";"75 a 79";719;916;1635
"2274";"peñaflor";"80 a 84";394;567;961
"2275";"peñaflor";"85 a 89";205;382;587
"2276";"peñaflor";"90 a 94";78;184;262
"2277";"peñaflor";"95 a 99";19;39;58
"2278";"peñaflor";"100 o más";6;11;17
"2279";"rancagua";"20 a 24";8951;8523;17474
"2280";"rancagua";"25 a 29";10090;9918;20008
"2281";"rancagua";"30 a 34";8833;8884;17717
"2282";"rancagua";"35 a 39";8373;8347;16720
"2283";"rancagua";"40 a 44";7899;8512;16411
"2284";"rancagua";"45 a 49";7616;8262;15878
"2285";"rancagua";"50 a 54";7637;8502;16139
"2286";"rancagua";"55 a 59";6693;7642;14335
"2287";"rancagua";"60 a 64";5532;6626;12158
"2288";"rancagua";"65 a 69";4295;5155;9450
"2289";"rancagua";"70 a 74";3128;3914;7042
"2290";"rancagua";"75 a 79";2070;2772;4842
"2291";"rancagua";"80 a 84";1157;1911;3068
"2292";"rancagua";"85 a 89";631;1238;1869
"2293";"rancagua";"90 a 94";203;499;702
"2294";"rancagua";"95 a 99";43;125;168
"2295";"rancagua";"100 o más";17;28;45
"2296";"codegua";"20 a 24";446;437;883
"2297";"codegua";"25 a 29";509;513;1022
"2298";"codegua";"30 a 34";434;428;862
"2299";"codegua";"35 a 39";444;426;870
"2300";"codegua";"40 a 44";447;453;900
"2301";"codegua";"45 a 49";421;443;864
"2302";"codegua";"50 a 54";521;475;996
"2303";"codegua";"55 a 59";446;426;872
"2304";"codegua";"60 a 64";356;334;690
"2305";"codegua";"65 a 69";244;227;471
"2306";"codegua";"70 a 74";179;171;350
"2307";"codegua";"75 a 79";102;132;234
"2308";"codegua";"80 a 84";79;86;165
"2309";"codegua";"85 a 89";45;52;97
"2310";"codegua";"90 a 94";15;15;30
"2311";"codegua";"95 a 99";1;6;7
"2312";"codegua";"100 o más";1;4;5
"2313";"coinco";"20 a 24";248;231;479
"2314";"coinco";"25 a 29";262;253;515
"2315";"coinco";"30 a 34";245;216;461
"2316";"coinco";"35 a 39";271;222;493
"2317";"coinco";"40 a 44";213;226;439
"2318";"coinco";"45 a 49";235;272;507
"2319";"coinco";"50 a 54";273;284;557
"2320";"coinco";"55 a 59";265;234;499
"2321";"coinco";"60 a 64";204;220;424
"2322";"coinco";"65 a 69";169;162;331
"2323";"coinco";"70 a 74";142;132;274
"2324";"coinco";"75 a 79";133;99;232
"2325";"coinco";"80 a 84";52;68;120
"2326";"coinco";"85 a 89";27;38;65
"2327";"coinco";"90 a 94";19;11;30
"2328";"coinco";"95 a 99";5;4;9
"2329";"coinco";"100 o más";2;6;8
"2330";"coltauco";"20 a 24";735;691;1426
"2331";"coltauco";"25 a 29";713;717;1430
"2332";"coltauco";"30 a 34";615;603;1218
"2333";"coltauco";"35 a 39";641;602;1243
"2334";"coltauco";"40 a 44";630;686;1316
"2335";"coltauco";"45 a 49";648;626;1274
"2336";"coltauco";"50 a 54";684;719;1403
"2337";"coltauco";"55 a 59";667;610;1277
"2338";"coltauco";"60 a 64";512;559;1071
"2339";"coltauco";"65 a 69";438;395;833
"2340";"coltauco";"70 a 74";301;309;610
"2341";"coltauco";"75 a 79";207;229;436
"2342";"coltauco";"80 a 84";130;154;284
"2343";"coltauco";"85 a 89";88;108;196
"2344";"coltauco";"90 a 94";21;48;69
"2345";"coltauco";"95 a 99";3;14;17
"2346";"coltauco";"100 o más";0;3;3
"2347";"doñihue";"20 a 24";728;720;1448
"2348";"doñihue";"25 a 29";751;745;1496
"2349";"doñihue";"30 a 34";712;691;1403
"2350";"doñihue";"35 a 39";725;757;1482
"2351";"doñihue";"40 a 44";716;739;1455
"2352";"doñihue";"45 a 49";713;722;1435
"2353";"doñihue";"50 a 54";691;729;1420
"2354";"doñihue";"55 a 59";598;652;1250
"2355";"doñihue";"60 a 64";568;566;1134
"2356";"doñihue";"65 a 69";418;414;832
"2357";"doñihue";"70 a 74";289;311;600
"2358";"doñihue";"75 a 79";204;232;436
"2359";"doñihue";"80 a 84";125;159;284
"2360";"doñihue";"85 a 89";70;108;178
"2361";"doñihue";"90 a 94";19;26;45
"2362";"doñihue";"95 a 99";5;11;16
"2363";"doñihue";"100 o más";0;2;2
"2364";"graneros";"20 a 24";1248;1221;2469
"2365";"graneros";"25 a 29";1266;1369;2635
"2366";"graneros";"30 a 34";1208;1240;2448
"2367";"graneros";"35 a 39";1173;1157;2330
"2368";"graneros";"40 a 44";1150;1147;2297
"2369";"graneros";"45 a 49";1068;1150;2218
"2370";"graneros";"50 a 54";1152;1112;2264
"2371";"graneros";"55 a 59";947;1022;1969
"2372";"graneros";"60 a 64";699;751;1450
"2373";"graneros";"65 a 69";536;577;1113
"2374";"graneros";"70 a 74";400;486;886
"2375";"graneros";"75 a 79";271;263;534
"2376";"graneros";"80 a 84";177;208;385
"2377";"graneros";"85 a 89";87;118;205
"2378";"graneros";"90 a 94";19;33;52
"2379";"graneros";"95 a 99";1;9;10
"2380";"graneros";"100 o más";1;7;8
"2381";"las cabras";"20 a 24";803;763;1566
"2382";"las cabras";"25 a 29";891;896;1787
"2383";"las cabras";"30 a 34";801;818;1619
"2384";"las cabras";"35 a 39";848;821;1669
"2385";"las cabras";"40 a 44";896;837;1733
"2386";"las cabras";"45 a 49";884;854;1738
"2387";"las cabras";"50 a 54";1031;914;1945
"2388";"las cabras";"55 a 59";840;765;1605
"2389";"las cabras";"60 a 64";710;616;1326
"2390";"las cabras";"65 a 69";517;490;1007
"2391";"las cabras";"70 a 74";427;384;811
"2392";"las cabras";"75 a 79";289;305;594
"2393";"las cabras";"80 a 84";221;183;404
"2394";"las cabras";"85 a 89";105;120;225
"2395";"las cabras";"90 a 94";39;51;90
"2396";"las cabras";"95 a 99";11;14;25
"2397";"las cabras";"100 o más";6;2;8
"2398";"machalí";"20 a 24";1394;1347;2741
"2399";"machalí";"25 a 29";1774;1882;3656
"2400";"machalí";"30 a 34";1921;2176;4097
"2401";"machalí";"35 a 39";2242;2412;4654
"2402";"machalí";"40 a 44";2154;2368;4522
"2403";"machalí";"45 a 49";1769;1850;3619
"2404";"machalí";"50 a 54";1567;1686;3253
"2405";"machalí";"55 a 59";1342;1446;2788
"2406";"machalí";"60 a 64";1078;1149;2227
"2407";"machalí";"65 a 69";801;836;1637
"2408";"machalí";"70 a 74";522;658;1180
"2409";"machalí";"75 a 79";306;364;670
"2410";"machalí";"80 a 84";177;256;433
"2411";"machalí";"85 a 89";107;165;272
"2412";"machalí";"90 a 94";35;65;100
"2413";"machalí";"95 a 99";6;16;22
"2414";"machalí";"100 o más";5;4;9
"2415";"malloa";"20 a 24";490;464;954
"2416";"malloa";"25 a 29";509;501;1010
"2417";"malloa";"30 a 34";375;444;819
"2418";"malloa";"35 a 39";420;371;791
"2419";"malloa";"40 a 44";424;446;870
"2420";"malloa";"45 a 49";474;450;924
"2421";"malloa";"50 a 54";555;534;1089
"2422";"malloa";"55 a 59";471;470;941
"2423";"malloa";"60 a 64";379;359;738
"2424";"malloa";"65 a 69";326;276;602
"2425";"malloa";"70 a 74";264;239;503
"2426";"malloa";"75 a 79";157;162;319
"2427";"malloa";"80 a 84";99;105;204
"2428";"malloa";"85 a 89";43;87;130
"2429";"malloa";"90 a 94";20;27;47
"2430";"malloa";"95 a 99";6;8;14
"2431";"malloa";"100 o más";0;1;1
"2432";"mostazal";"20 a 24";925;914;1839
"2433";"mostazal";"25 a 29";954;955;1909
"2434";"mostazal";"30 a 34";776;810;1586
"2435";"mostazal";"35 a 39";851;842;1693
"2436";"mostazal";"40 a 44";901;885;1786
"2437";"mostazal";"45 a 49";845;842;1687
"2438";"mostazal";"50 a 54";858;882;1740
"2439";"mostazal";"55 a 59";759;857;1616
"2440";"mostazal";"60 a 64";674;568;1242
"2441";"mostazal";"65 a 69";488;493;981
"2442";"mostazal";"70 a 74";364;392;756
"2443";"mostazal";"75 a 79";265;240;505
"2444";"mostazal";"80 a 84";148;169;317
"2445";"mostazal";"85 a 89";71;108;179
"2446";"mostazal";"90 a 94";26;42;68
"2447";"mostazal";"95 a 99";3;8;11
"2448";"mostazal";"100 o más";4;4;8
"2449";"olivar";"20 a 24";471;465;936
"2450";"olivar";"25 a 29";510;501;1011
"2451";"olivar";"30 a 34";472;414;886
"2452";"olivar";"35 a 39";436;450;886
"2453";"olivar";"40 a 44";498;532;1030
"2454";"olivar";"45 a 49";517;470;987
"2455";"olivar";"50 a 54";449;465;914
"2456";"olivar";"55 a 59";409;431;840
"2457";"olivar";"60 a 64";392;351;743
"2458";"olivar";"65 a 69";262;254;516
"2459";"olivar";"70 a 74";179;197;376
"2460";"olivar";"75 a 79";122;130;252
"2461";"olivar";"80 a 84";61;97;158
"2462";"olivar";"85 a 89";41;53;94
"2463";"olivar";"90 a 94";11;23;34
"2464";"olivar";"95 a 99";1;6;7
"2465";"olivar";"100 o más";1;3;4
"2466";"peumo";"20 a 24";490;459;949
"2467";"peumo";"25 a 29";586;517;1103
"2468";"peumo";"30 a 34";483;447;930
"2469";"peumo";"35 a 39";488;455;943
"2470";"peumo";"40 a 44";514;473;987
"2471";"peumo";"45 a 49";492;513;1005
"2472";"peumo";"50 a 54";570;561;1131
"2473";"peumo";"55 a 59";495;449;944
"2474";"peumo";"60 a 64";393;389;782
"2475";"peumo";"65 a 69";304;322;626
"2476";"peumo";"70 a 74";248;227;475
"2477";"peumo";"75 a 79";152;177;329
"2478";"peumo";"80 a 84";86;115;201
"2479";"peumo";"85 a 89";42;80;122
"2480";"peumo";"90 a 94";18;32;50
"2481";"peumo";"95 a 99";8;9;17
"2482";"peumo";"100 o más";3;3;6
"2483";"pichidegua";"20 a 24";621;594;1215
"2484";"pichidegua";"25 a 29";673;640;1313
"2485";"pichidegua";"30 a 34";602;632;1234
"2486";"pichidegua";"35 a 39";656;593;1249
"2487";"pichidegua";"40 a 44";660;694;1354
"2488";"pichidegua";"45 a 49";763;787;1550
"2489";"pichidegua";"50 a 54";787;766;1553
"2490";"pichidegua";"55 a 59";683;656;1339
"2491";"pichidegua";"60 a 64";637;564;1201
"2492";"pichidegua";"65 a 69";506;438;944
"2493";"pichidegua";"70 a 74";362;310;672
"2494";"pichidegua";"75 a 79";219;243;462
"2495";"pichidegua";"80 a 84";173;142;315
"2496";"pichidegua";"85 a 89";85;107;192
"2497";"pichidegua";"90 a 94";29;49;78
"2498";"pichidegua";"95 a 99";8;8;16
"2499";"pichidegua";"100 o más";2;1;3
"2500";"quinta de tilcoco";"20 a 24";418;375;793
"2501";"quinta de tilcoco";"25 a 29";508;493;1001
"2502";"quinta de tilcoco";"30 a 34";449;471;920
"2503";"quinta de tilcoco";"35 a 39";422;422;844
"2504";"quinta de tilcoco";"40 a 44";459;411;870
"2505";"quinta de tilcoco";"45 a 49";460;470;930
"2506";"quinta de tilcoco";"50 a 54";516;542;1058
"2507";"quinta de tilcoco";"55 a 59";443;440;883
"2508";"quinta de tilcoco";"60 a 64";359;332;691
"2509";"quinta de tilcoco";"65 a 69";306;291;597
"2510";"quinta de tilcoco";"70 a 74";215;215;430
"2511";"quinta de tilcoco";"75 a 79";136;143;279
"2512";"quinta de tilcoco";"80 a 84";83;101;184
"2513";"quinta de tilcoco";"85 a 89";43;75;118
"2514";"quinta de tilcoco";"90 a 94";18;27;45
"2515";"quinta de tilcoco";"95 a 99";3;9;12
"2516";"quinta de tilcoco";"100 o más";1;1;2
"2517";"rengo";"20 a 24";2057;2070;4127
"2518";"rengo";"25 a 29";2441;2355;4796
"2519";"rengo";"30 a 34";2017;2126;4143
"2520";"rengo";"35 a 39";1931;2013;3944
"2521";"rengo";"40 a 44";1935;1988;3923
"2522";"rengo";"45 a 49";1948;2071;4019
"2523";"rengo";"50 a 54";1912;2168;4080
"2524";"rengo";"55 a 59";1719;1853;3572
"2525";"rengo";"60 a 64";1426;1443;2869
"2526";"rengo";"65 a 69";1077;1200;2277
"2527";"rengo";"70 a 74";872;920;1792
"2528";"rengo";"75 a 79";545;678;1223
"2529";"rengo";"80 a 84";308;404;712
"2530";"rengo";"85 a 89";204;272;476
"2531";"rengo";"90 a 94";59;119;178
"2532";"rengo";"95 a 99";15;47;62
"2533";"rengo";"100 o más";5;10;15
"2534";"requínoa";"20 a 24";1011;989;2000
"2535";"requínoa";"25 a 29";1098;1048;2146
"2536";"requínoa";"30 a 34";941;917;1858
"2537";"requínoa";"35 a 39";925;923;1848
"2538";"requínoa";"40 a 44";1038;1108;2146
"2539";"requínoa";"45 a 49";1046;1052;2098
"2540";"requínoa";"50 a 54";1030;1002;2032
"2541";"requínoa";"55 a 59";887;811;1698
"2542";"requínoa";"60 a 64";647;629;1276
"2543";"requínoa";"65 a 69";472;499;971
"2544";"requínoa";"70 a 74";353;364;717
"2545";"requínoa";"75 a 79";255;244;499
"2546";"requínoa";"80 a 84";136;160;296
"2547";"requínoa";"85 a 89";71;89;160
"2548";"requínoa";"90 a 94";29;44;73
"2549";"requínoa";"95 a 99";6;9;15
"2550";"requínoa";"100 o más";4;2;6
"2551";"san vicente";"20 a 24";1393;1322;2715
"2552";"san vicente";"25 a 29";1673;1722;3395
"2553";"san vicente";"30 a 34";1531;1549;3080
"2554";"san vicente";"35 a 39";1532;1609;3141
"2555";"san vicente";"40 a 44";1639;1682;3321
"2556";"san vicente";"45 a 49";1599;1628;3227
"2557";"san vicente";"50 a 54";1754;1889;3643
"2558";"san vicente";"55 a 59";1529;1586;3115
"2559";"san vicente";"60 a 64";1294;1330;2624
"2560";"san vicente";"65 a 69";972;1038;2010
"2561";"san vicente";"70 a 74";815;815;1630
"2562";"san vicente";"75 a 79";547;586;1133
"2563";"san vicente";"80 a 84";361;394;755
"2564";"san vicente";"85 a 89";197;299;496
"2565";"san vicente";"90 a 94";58;89;147
"2566";"san vicente";"95 a 99";17;39;56
"2567";"san vicente";"100 o más";9;5;14
"2568";"pichilemu";"20 a 24";460;393;853
"2569";"pichilemu";"25 a 29";613;644;1257
"2570";"pichilemu";"30 a 34";609;622;1231
"2571";"pichilemu";"35 a 39";578;562;1140
"2572";"pichilemu";"40 a 44";574;575;1149
"2573";"pichilemu";"45 a 49";593;580;1173
"2574";"pichilemu";"50 a 54";605;624;1229
"2575";"pichilemu";"55 a 59";596;561;1157
"2576";"pichilemu";"60 a 64";470;474;944
"2577";"pichilemu";"65 a 69";392;351;743
"2578";"pichilemu";"70 a 74";279;274;553
"2579";"pichilemu";"75 a 79";178;229;407
"2580";"pichilemu";"80 a 84";121;146;267
"2581";"pichilemu";"85 a 89";68;82;150
"2582";"pichilemu";"90 a 94";23;30;53
"2583";"pichilemu";"95 a 99";2;13;15
"2584";"pichilemu";"100 o más";1;0;1
"2585";"la estrella";"20 a 24";78;65;143
"2586";"la estrella";"25 a 29";99;77;176
"2587";"la estrella";"30 a 34";103;95;198
"2588";"la estrella";"35 a 39";95;81;176
"2589";"la estrella";"40 a 44";116;89;205
"2590";"la estrella";"45 a 49";110;117;227
"2591";"la estrella";"50 a 54";146;114;260
"2592";"la estrella";"55 a 59";141;121;262
"2593";"la estrella";"60 a 64";116;95;211
"2594";"la estrella";"65 a 69";96;80;176
"2595";"la estrella";"70 a 74";71;72;143
"2596";"la estrella";"75 a 79";48;50;98
"2597";"la estrella";"80 a 84";31;21;52
"2598";"la estrella";"85 a 89";18;25;43
"2599";"la estrella";"90 a 94";6;18;24
"2600";"la estrella";"95 a 99";0;1;1
"2601";"la estrella";"100 o más";2;1;3
"2602";"litueche";"20 a 24";200;174;374
"2603";"litueche";"25 a 29";219;221;440
"2604";"litueche";"30 a 34";214;213;427
"2605";"litueche";"35 a 39";192;167;359
"2606";"litueche";"40 a 44";213;218;431
"2607";"litueche";"45 a 49";236;241;477
"2608";"litueche";"50 a 54";258;226;484
"2609";"litueche";"55 a 59";260;195;455
"2610";"litueche";"60 a 64";181;180;361
"2611";"litueche";"65 a 69";190;157;347
"2612";"litueche";"70 a 74";141;102;243
"2613";"litueche";"75 a 79";90;79;169
"2614";"litueche";"80 a 84";59;58;117
"2615";"litueche";"85 a 89";30;38;68
"2616";"litueche";"90 a 94";13;10;23
"2617";"litueche";"95 a 99";2;6;8
"2618";"litueche";"100 o más";0;1;1
"2619";"marchihue";"20 a 24";207;200;407
"2620";"marchihue";"25 a 29";246;213;459
"2621";"marchihue";"30 a 34";236;235;471
"2622";"marchihue";"35 a 39";225;221;446
"2623";"marchihue";"40 a 44";287;254;541
"2624";"marchihue";"45 a 49";282;278;560
"2625";"marchihue";"50 a 54";320;259;579
"2626";"marchihue";"55 a 59";274;254;528
"2627";"marchihue";"60 a 64";220;208;428
"2628";"marchihue";"65 a 69";200;185;385
"2629";"marchihue";"70 a 74";151;149;300
"2630";"marchihue";"75 a 79";132;99;231
"2631";"marchihue";"80 a 84";74;63;137
"2632";"marchihue";"85 a 89";36;60;96
"2633";"marchihue";"90 a 94";14;24;38
"2634";"marchihue";"95 a 99";5;4;9
"2635";"marchihue";"100 o más";1;2;3
"2636";"navidad";"20 a 24";162;132;294
"2637";"navidad";"25 a 29";221;195;416
"2638";"navidad";"30 a 34";197;208;405
"2639";"navidad";"35 a 39";210;168;378
"2640";"navidad";"40 a 44";215;152;367
"2641";"navidad";"45 a 49";260;210;470
"2642";"navidad";"50 a 54";267;254;521
"2643";"navidad";"55 a 59";271;249;520
"2644";"navidad";"60 a 64";232;213;445
"2645";"navidad";"65 a 69";223;192;415
"2646";"navidad";"70 a 74";192;188;380
"2647";"navidad";"75 a 79";137;127;264
"2648";"navidad";"80 a 84";99;86;185
"2649";"navidad";"85 a 89";43;75;118
"2650";"navidad";"90 a 94";16;27;43
"2651";"navidad";"95 a 99";0;6;6
"2652";"navidad";"100 o más";0;3;3
"2653";"paredones";"20 a 24";160;148;308
"2654";"paredones";"25 a 29";179;173;352
"2655";"paredones";"30 a 34";174;160;334
"2656";"paredones";"35 a 39";181;165;346
"2657";"paredones";"40 a 44";236;203;439
"2658";"paredones";"45 a 49";269;249;518
"2659";"paredones";"50 a 54";288;222;510
"2660";"paredones";"55 a 59";271;220;491
"2661";"paredones";"60 a 64";221;168;389
"2662";"paredones";"65 a 69";152;165;317
"2663";"paredones";"70 a 74";145;136;281
"2664";"paredones";"75 a 79";115;131;246
"2665";"paredones";"80 a 84";92;83;175
"2666";"paredones";"85 a 89";46;49;95
"2667";"paredones";"90 a 94";17;31;48
"2668";"paredones";"95 a 99";4;10;14
"2669";"paredones";"100 o más";2;1;3
"2670";"san fernando";"20 a 24";2380;2299;4679
"2671";"san fernando";"25 a 29";2754;2845;5599
"2672";"san fernando";"30 a 34";2502;2680;5182
"2673";"san fernando";"35 a 39";2412;2569;4981
"2674";"san fernando";"40 a 44";2473;2710;5183
"2675";"san fernando";"45 a 49";2424;2589;5013
"2676";"san fernando";"50 a 54";2533;2744;5277
"2677";"san fernando";"55 a 59";2163;2424;4587
"2678";"san fernando";"60 a 64";1721;1982;3703
"2679";"san fernando";"65 a 69";1344;1469;2813
"2680";"san fernando";"70 a 74";1036;1241;2277
"2681";"san fernando";"75 a 79";713;891;1604
"2682";"san fernando";"80 a 84";405;600;1005
"2683";"san fernando";"85 a 89";228;421;649
"2684";"san fernando";"90 a 94";73;170;243
"2685";"san fernando";"95 a 99";18;48;66
"2686";"san fernando";"100 o más";3;10;13
"2687";"chépica";"20 a 24";447;485;932
"2688";"chépica";"25 a 29";553;532;1085
"2689";"chépica";"30 a 34";517;486;1003
"2690";"chépica";"35 a 39";482;491;973
"2691";"chépica";"40 a 44";521;507;1028
"2692";"chépica";"45 a 49";534;531;1065
"2693";"chépica";"50 a 54";555;563;1118
"2694";"chépica";"55 a 59";539;493;1032
"2695";"chépica";"60 a 64";408;445;853
"2696";"chépica";"65 a 69";369;336;705
"2697";"chépica";"70 a 74";275;276;551
"2698";"chépica";"75 a 79";184;212;396
"2699";"chépica";"80 a 84";137;127;264
"2700";"chépica";"85 a 89";77;94;171
"2701";"chépica";"90 a 94";30;31;61
"2702";"chépica";"95 a 99";10;10;20
"2703";"chépica";"100 o más";5;2;7
"2704";"chimbarongo";"20 a 24";1194;1204;2398
"2705";"chimbarongo";"25 a 29";1304;1226;2530
"2706";"chimbarongo";"30 a 34";1160;1122;2282
"2707";"chimbarongo";"35 a 39";1115;1205;2320
"2708";"chimbarongo";"40 a 44";1260;1363;2623
"2709";"chimbarongo";"45 a 49";1228;1219;2447
"2710";"chimbarongo";"50 a 54";1455;1356;2811
"2711";"chimbarongo";"55 a 59";1195;1116;2311
"2712";"chimbarongo";"60 a 64";871;913;1784
"2713";"chimbarongo";"65 a 69";722;701;1423
"2714";"chimbarongo";"70 a 74";553;548;1101
"2715";"chimbarongo";"75 a 79";382;390;772
"2716";"chimbarongo";"80 a 84";226;263;489
"2717";"chimbarongo";"85 a 89";134;154;288
"2718";"chimbarongo";"90 a 94";44;63;107
"2719";"chimbarongo";"95 a 99";9;10;19
"2720";"chimbarongo";"100 o más";8;6;14
"2721";"lolol";"20 a 24";202;154;356
"2722";"lolol";"25 a 29";226;235;461
"2723";"lolol";"30 a 34";228;206;434
"2724";"lolol";"35 a 39";235;209;444
"2725";"lolol";"40 a 44";236;248;484
"2726";"lolol";"45 a 49";263;257;520
"2727";"lolol";"50 a 54";277;234;511
"2728";"lolol";"55 a 59";207;223;430
"2729";"lolol";"60 a 64";199;191;390
"2730";"lolol";"65 a 69";191;167;358
"2731";"lolol";"70 a 74";162;156;318
"2732";"lolol";"75 a 79";106;104;210
"2733";"lolol";"80 a 84";67;81;148
"2734";"lolol";"85 a 89";46;60;106
"2735";"lolol";"90 a 94";8;17;25
"2736";"lolol";"95 a 99";4;7;11
"2737";"lolol";"100 o más";2;1;3
"2738";"nancagua";"20 a 24";541;628;1169
"2739";"nancagua";"25 a 29";696;677;1373
"2740";"nancagua";"30 a 34";567;585;1152
"2741";"nancagua";"35 a 39";616;582;1198
"2742";"nancagua";"40 a 44";606;650;1256
"2743";"nancagua";"45 a 49";601;602;1203
"2744";"nancagua";"50 a 54";690;733;1423
"2745";"nancagua";"55 a 59";563;550;1113
"2746";"nancagua";"60 a 64";472;457;929
"2747";"nancagua";"65 a 69";331;353;684
"2748";"nancagua";"70 a 74";312;293;605
"2749";"nancagua";"75 a 79";195;233;428
"2750";"nancagua";"80 a 84";112;150;262
"2751";"nancagua";"85 a 89";67;97;164
"2752";"nancagua";"90 a 94";20;36;56
"2753";"nancagua";"95 a 99";5;15;20
"2754";"nancagua";"100 o más";3;3;6
"2755";"palmilla";"20 a 24";386;354;740
"2756";"palmilla";"25 a 29";437;468;905
"2757";"palmilla";"30 a 34";430;424;854
"2758";"palmilla";"35 a 39";437;397;834
"2759";"palmilla";"40 a 44";450;492;942
"2760";"palmilla";"45 a 49";435;490;925
"2761";"palmilla";"50 a 54";516;485;1001
"2762";"palmilla";"55 a 59";502;405;907
"2763";"palmilla";"60 a 64";345;358;703
"2764";"palmilla";"65 a 69";261;241;502
"2765";"palmilla";"70 a 74";231;193;424
"2766";"palmilla";"75 a 79";143;151;294
"2767";"palmilla";"80 a 84";95;102;197
"2768";"palmilla";"85 a 89";50;56;106
"2769";"palmilla";"90 a 94";16;26;42
"2770";"palmilla";"95 a 99";5;4;9
"2771";"palmilla";"100 o más";1;2;3
"2772";"peralillo";"20 a 24";310;303;613
"2773";"peralillo";"25 a 29";373;387;760
"2774";"peralillo";"30 a 34";373;395;768
"2775";"peralillo";"35 a 39";386;325;711
"2776";"peralillo";"40 a 44";395;428;823
"2777";"peralillo";"45 a 49";417;414;831
"2778";"peralillo";"50 a 54";450;412;862
"2779";"peralillo";"55 a 59";394;357;751
"2780";"peralillo";"60 a 64";303;287;590
"2781";"peralillo";"65 a 69";253;270;523
"2782";"peralillo";"70 a 74";211;194;405
"2783";"peralillo";"75 a 79";154;145;299
"2784";"peralillo";"80 a 84";99;102;201
"2785";"peralillo";"85 a 89";58;67;125
"2786";"peralillo";"90 a 94";14;26;40
"2787";"peralillo";"95 a 99";6;5;11
"2788";"peralillo";"100 o más";1;4;5
"2789";"placilla";"20 a 24";291;295;586
"2790";"placilla";"25 a 29";339;280;619
"2791";"placilla";"30 a 34";261;269;530
"2792";"placilla";"35 a 39";261;290;551
"2793";"placilla";"40 a 44";336;311;647
"2794";"placilla";"45 a 49";297;294;591
"2795";"placilla";"50 a 54";365;349;714
"2796";"placilla";"55 a 59";318;319;637
"2797";"placilla";"60 a 64";230;235;465
"2798";"placilla";"65 a 69";217;173;390
"2799";"placilla";"70 a 74";124;157;281
"2800";"placilla";"75 a 79";104;113;217
"2801";"placilla";"80 a 84";59;71;130
"2802";"placilla";"85 a 89";51;58;109
"2803";"placilla";"90 a 94";11;19;30
"2804";"placilla";"95 a 99";3;5;8
"2805";"placilla";"100 o más";2;1;3
"2806";"pumanque";"20 a 24";113;88;201
"2807";"pumanque";"25 a 29";122;122;244
"2808";"pumanque";"30 a 34";114;97;211
"2809";"pumanque";"35 a 39";107;97;204
"2810";"pumanque";"40 a 44";116;109;225
"2811";"pumanque";"45 a 49";130;111;241
"2812";"pumanque";"50 a 54";153;120;273
"2813";"pumanque";"55 a 59";127;124;251
"2814";"pumanque";"60 a 64";105;125;230
"2815";"pumanque";"65 a 69";107;94;201
"2816";"pumanque";"70 a 74";75;90;165
"2817";"pumanque";"75 a 79";56;60;116
"2818";"pumanque";"80 a 84";35;45;80
"2819";"pumanque";"85 a 89";26;32;58
"2820";"pumanque";"90 a 94";7;11;18
"2821";"pumanque";"95 a 99";4;6;10
"2822";"pumanque";"100 o más";1;0;1
"2823";"santa cruz";"20 a 24";1105;1061;2166
"2824";"santa cruz";"25 a 29";1395;1397;2792
"2825";"santa cruz";"30 a 34";1355;1402;2757
"2826";"santa cruz";"35 a 39";1319;1370;2689
"2827";"santa cruz";"40 a 44";1348;1404;2752
"2828";"santa cruz";"45 a 49";1348;1418;2766
"2829";"santa cruz";"50 a 54";1345;1387;2732
"2830";"santa cruz";"55 a 59";1183;1205;2388
"2831";"santa cruz";"60 a 64";950;1028;1978
"2832";"santa cruz";"65 a 69";767;819;1586
"2833";"santa cruz";"70 a 74";538;645;1183
"2834";"santa cruz";"75 a 79";409;491;900
"2835";"santa cruz";"80 a 84";260;372;632
"2836";"santa cruz";"85 a 89";160;219;379
"2837";"santa cruz";"90 a 94";33;81;114
"2838";"santa cruz";"95 a 99";11;28;39
"2839";"santa cruz";"100 o más";9;13;22
"2840";"talca";"20 a 24";9865;10333;20198
"2841";"talca";"25 a 29";9070;9206;18276
"2842";"talca";"30 a 34";7308;7489;14797
"2843";"talca";"35 a 39";6588;7046;13634
"2844";"talca";"40 a 44";6881;7628;14509
"2845";"talca";"45 a 49";6465;7461;13926
"2846";"talca";"50 a 54";6790;8069;14859
"2847";"talca";"55 a 59";6025;7184;13209
"2848";"talca";"60 a 64";5136;6113;11249
"2849";"talca";"65 a 69";4051;4857;8908
"2850";"talca";"70 a 74";3023;3919;6942
"2851";"talca";"75 a 79";2018;2609;4627
"2852";"talca";"80 a 84";1179;1840;3019
"2853";"talca";"85 a 89";645;1230;1875
"2854";"talca";"90 a 94";197;496;693
"2855";"talca";"95 a 99";41;144;185
"2856";"talca";"100 o más";14;59;73
"2857";"constitución";"20 a 24";1483;1527;3010
"2858";"constitución";"25 a 29";1844;1880;3724
"2859";"constitución";"30 a 34";1525;1600;3125
"2860";"constitución";"35 a 39";1611;1628;3239
"2861";"constitución";"40 a 44";1702;1695;3397
"2862";"constitución";"45 a 49";1558;1573;3131
"2863";"constitución";"50 a 54";1617;1660;3277
"2864";"constitución";"55 a 59";1420;1409;2829
"2865";"constitución";"60 a 64";1155;1173;2328
"2866";"constitución";"65 a 69";913;806;1719
"2867";"constitución";"70 a 74";623;584;1207
"2868";"constitución";"75 a 79";353;461;814
"2869";"constitución";"80 a 84";206;275;481
"2870";"constitución";"85 a 89";114;183;297
"2871";"constitución";"90 a 94";43;53;96
"2872";"constitución";"95 a 99";15;23;38
"2873";"constitución";"100 o más";5;7;12
"2874";"curepto";"20 a 24";242;237;479
"2875";"curepto";"25 a 29";253;276;529
"2876";"curepto";"30 a 34";262;238;500
"2877";"curepto";"35 a 39";250;296;546
"2878";"curepto";"40 a 44";331;315;646
"2879";"curepto";"45 a 49";370;287;657
"2880";"curepto";"50 a 54";382;341;723
"2881";"curepto";"55 a 59";381;345;726
"2882";"curepto";"60 a 64";375;311;686
"2883";"curepto";"65 a 69";268;268;536
"2884";"curepto";"70 a 74";234;198;432
"2885";"curepto";"75 a 79";192;236;428
"2886";"curepto";"80 a 84";126;160;286
"2887";"curepto";"85 a 89";75;86;161
"2888";"curepto";"90 a 94";25;47;72
"2889";"curepto";"95 a 99";6;11;17
"2890";"curepto";"100 o más";2;0;2
"2891";"empedrado";"20 a 24";139;138;277
"2892";"empedrado";"25 a 29";148;153;301
"2893";"empedrado";"30 a 34";135;141;276
"2894";"empedrado";"35 a 39";167;144;311
"2895";"empedrado";"40 a 44";181;144;325
"2896";"empedrado";"45 a 49";172;162;334
"2897";"empedrado";"50 a 54";140;111;251
"2898";"empedrado";"55 a 59";141;107;248
"2899";"empedrado";"60 a 64";115;84;199
"2900";"empedrado";"65 a 69";98;65;163
"2901";"empedrado";"70 a 74";71;71;142
"2902";"empedrado";"75 a 79";54;42;96
"2903";"empedrado";"80 a 84";32;36;68
"2904";"empedrado";"85 a 89";14;23;37
"2905";"empedrado";"90 a 94";6;8;14
"2906";"empedrado";"95 a 99";0;0;0
"2907";"empedrado";"100 o más";4;1;5
"2908";"maule";"20 a 24";1665;1799;3464
"2909";"maule";"25 a 29";1928;2193;4121
"2910";"maule";"30 a 34";1963;2286;4249
"2911";"maule";"35 a 39";1947;2240;4187
"2912";"maule";"40 a 44";1830;1909;3739
"2913";"maule";"45 a 49";1510;1702;3212
"2914";"maule";"50 a 54";1384;1483;2867
"2915";"maule";"55 a 59";1093;1121;2214
"2916";"maule";"60 a 64";850;858;1708
"2917";"maule";"65 a 69";615;612;1227
"2918";"maule";"70 a 74";452;475;927
"2919";"maule";"75 a 79";261;302;563
"2920";"maule";"80 a 84";147;207;354
"2921";"maule";"85 a 89";80;112;192
"2922";"maule";"90 a 94";30;46;76
"2923";"maule";"95 a 99";8;15;23
"2924";"maule";"100 o más";3;4;7
"2925";"pelarco";"20 a 24";279;325;604
"2926";"pelarco";"25 a 29";310;323;633
"2927";"pelarco";"30 a 34";233;257;490
"2928";"pelarco";"35 a 39";240;249;489
"2929";"pelarco";"40 a 44";272;300;572
"2930";"pelarco";"45 a 49";295;290;585
"2931";"pelarco";"50 a 54";324;306;630
"2932";"pelarco";"55 a 59";283;251;534
"2933";"pelarco";"60 a 64";238;236;474
"2934";"pelarco";"65 a 69";202;190;392
"2935";"pelarco";"70 a 74";174;141;315
"2936";"pelarco";"75 a 79";97;110;207
"2937";"pelarco";"80 a 84";84;94;178
"2938";"pelarco";"85 a 89";39;44;83
"2939";"pelarco";"90 a 94";17;22;39
"2940";"pelarco";"95 a 99";4;2;6
"2941";"pelarco";"100 o más";4;2;6
"2942";"pencahue";"20 a 24";242;280;522
"2943";"pencahue";"25 a 29";240;242;482
"2944";"pencahue";"30 a 34";197;238;435
"2945";"pencahue";"35 a 39";260;274;534
"2946";"pencahue";"40 a 44";295;294;589
"2947";"pencahue";"45 a 49";338;306;644
"2948";"pencahue";"50 a 54";345;312;657
"2949";"pencahue";"55 a 59";335;242;577
"2950";"pencahue";"60 a 64";283;211;494
"2951";"pencahue";"65 a 69";214;205;419
"2952";"pencahue";"70 a 74";203;128;331
"2953";"pencahue";"75 a 79";98;123;221
"2954";"pencahue";"80 a 84";76;72;148
"2955";"pencahue";"85 a 89";45;54;99
"2956";"pencahue";"90 a 94";18;23;41
"2957";"pencahue";"95 a 99";4;10;14
"2958";"pencahue";"100 o más";1;2;3
"2959";"río claro";"20 a 24";517;494;1011
"2960";"río claro";"25 a 29";492;460;952
"2961";"río claro";"30 a 34";431;417;848
"2962";"río claro";"35 a 39";447;424;871
"2963";"río claro";"40 a 44";534;495;1029
"2964";"río claro";"45 a 49";481;494;975
"2965";"río claro";"50 a 54";629;522;1151
"2966";"río claro";"55 a 59";505;403;908
"2967";"río claro";"60 a 64";441;367;808
"2968";"río claro";"65 a 69";345;283;628
"2969";"río claro";"70 a 74";264;228;492
"2970";"río claro";"75 a 79";178;180;358
"2971";"río claro";"80 a 84";97;93;190
"2972";"río claro";"85 a 89";47;46;93
"2973";"río claro";"90 a 94";30;19;49
"2974";"río claro";"95 a 99";7;3;10
"2975";"río claro";"100 o más";0;1;1
"2976";"san clemente";"20 a 24";1567;1602;3169
"2977";"san clemente";"25 a 29";1600;1638;3238
"2978";"san clemente";"30 a 34";1267;1352;2619
"2979";"san clemente";"35 a 39";1223;1397;2620
"2980";"san clemente";"40 a 44";1512;1524;3036
"2981";"san clemente";"45 a 49";1486;1584;3070
"2982";"san clemente";"50 a 54";1587;1541;3128
"2983";"san clemente";"55 a 59";1408;1277;2685
"2984";"san clemente";"60 a 64";1198;1099;2297
"2985";"san clemente";"65 a 69";966;894;1860
"2986";"san clemente";"70 a 74";770;659;1429
"2987";"san clemente";"75 a 79";506;477;983
"2988";"san clemente";"80 a 84";274;308;582
"2989";"san clemente";"85 a 89";167;169;336
"2990";"san clemente";"90 a 94";46;73;119
"2991";"san clemente";"95 a 99";16;19;35
"2992";"san clemente";"100 o más";4;5;9
"2993";"san rafael";"20 a 24";332;353;685
"2994";"san rafael";"25 a 29";322;350;672
"2995";"san rafael";"30 a 34";241;280;521
"2996";"san rafael";"35 a 39";238;282;520
"2997";"san rafael";"40 a 44";293;314;607
"2998";"san rafael";"45 a 49";325;334;659
"2999";"san rafael";"50 a 54";310;320;630
"3000";"san rafael";"55 a 59";299;272;571
"3001";"san rafael";"60 a 64";262;244;506
"3002";"san rafael";"65 a 69";207;201;408
"3003";"san rafael";"70 a 74";171;149;320
"3004";"san rafael";"75 a 79";103;102;205
"3005";"san rafael";"80 a 84";61;62;123
"3006";"san rafael";"85 a 89";36;34;70
"3007";"san rafael";"90 a 94";11;12;23
"3008";"san rafael";"95 a 99";1;3;4
"3009";"san rafael";"100 o más";1;1;2
"3010";"cauquenes";"20 a 24";1064;1207;2271
"3011";"cauquenes";"25 a 29";1264;1420;2684
"3012";"cauquenes";"30 a 34";1106;1231;2337
"3013";"cauquenes";"35 a 39";1209;1377;2586
"3014";"cauquenes";"40 a 44";1299;1363;2662
"3015";"cauquenes";"45 a 49";1327;1438;2765
"3016";"cauquenes";"50 a 54";1464;1477;2941
"3017";"cauquenes";"55 a 59";1274;1418;2692
"3018";"cauquenes";"60 a 64";1106;1173;2279
"3019";"cauquenes";"65 a 69";820;1006;1826
"3020";"cauquenes";"70 a 74";727;901;1628
"3021";"cauquenes";"75 a 79";604;705;1309
"3022";"cauquenes";"80 a 84";382;526;908
"3023";"cauquenes";"85 a 89";227;370;597
"3024";"cauquenes";"90 a 94";98;168;266
"3025";"cauquenes";"95 a 99";24;58;82
"3026";"cauquenes";"100 o más";4;16;20
"3027";"chanco";"20 a 24";224;233;457
"3028";"chanco";"25 a 29";277;315;592
"3029";"chanco";"30 a 34";268;285;553
"3030";"chanco";"35 a 39";271;280;551
"3031";"chanco";"40 a 44";279;307;586
"3032";"chanco";"45 a 49";346;311;657
"3033";"chanco";"50 a 54";360;339;699
"3034";"chanco";"55 a 59";356;312;668
"3035";"chanco";"60 a 64";278;228;506
"3036";"chanco";"65 a 69";197;202;399
"3037";"chanco";"70 a 74";180;172;352
"3038";"chanco";"75 a 79";128;144;272
"3039";"chanco";"80 a 84";93;105;198
"3040";"chanco";"85 a 89";54;68;122
"3041";"chanco";"90 a 94";9;26;35
"3042";"chanco";"95 a 99";2;8;10
"3043";"chanco";"100 o más";3;3;6
"3044";"pelluhue";"20 a 24";176;221;397
"3045";"pelluhue";"25 a 29";254;285;539
"3046";"pelluhue";"30 a 34";251;280;531
"3047";"pelluhue";"35 a 39";268;238;506
"3048";"pelluhue";"40 a 44";250;229;479
"3049";"pelluhue";"45 a 49";256;258;514
"3050";"pelluhue";"50 a 54";256;268;524
"3051";"pelluhue";"55 a 59";249;224;473
"3052";"pelluhue";"60 a 64";220;222;442
"3053";"pelluhue";"65 a 69";213;200;413
"3054";"pelluhue";"70 a 74";155;173;328
"3055";"pelluhue";"75 a 79";135;120;255
"3056";"pelluhue";"80 a 84";72;65;137
"3057";"pelluhue";"85 a 89";40;58;98
"3058";"pelluhue";"90 a 94";12;23;35
"3059";"pelluhue";"95 a 99";1;3;4
"3060";"pelluhue";"100 o más";0;0;0
"3061";"curicó";"20 a 24";5361;5246;10607
"3062";"curicó";"25 a 29";5931;6071;12002
"3063";"curicó";"30 a 34";5234;5491;10725
"3064";"curicó";"35 a 39";5056;5356;10412
"3065";"curicó";"40 a 44";5258;5693;10951
"3066";"curicó";"45 a 49";4776;5223;9999
"3067";"curicó";"50 a 54";5036;5527;10563
"3068";"curicó";"55 a 59";4307;4877;9184
"3069";"curicó";"60 a 64";3501;3821;7322
"3070";"curicó";"65 a 69";2614;2971;5585
"3071";"curicó";"70 a 74";1858;2259;4117
"3072";"curicó";"75 a 79";1322;1640;2962
"3073";"curicó";"80 a 84";688;1112;1800
"3074";"curicó";"85 a 89";412;710;1122
"3075";"curicó";"90 a 94";139;288;427
"3076";"curicó";"95 a 99";29;72;101
"3077";"curicó";"100 o más";17;31;48
"3078";"hualañé";"20 a 24";274;276;550
"3079";"hualañé";"25 a 29";299;316;615
"3080";"hualañé";"30 a 34";258;278;536
"3081";"hualañé";"35 a 39";287;298;585
"3082";"hualañé";"40 a 44";340;324;664
"3083";"hualañé";"45 a 49";359;376;735
"3084";"hualañé";"50 a 54";366;346;712
"3085";"hualañé";"55 a 59";362;320;682
"3086";"hualañé";"60 a 64";313;315;628
"3087";"hualañé";"65 a 69";269;242;511
"3088";"hualañé";"70 a 74";221;192;413
"3089";"hualañé";"75 a 79";138;133;271
"3090";"hualañé";"80 a 84";95;113;208
"3091";"hualañé";"85 a 89";66;72;138
"3092";"hualañé";"90 a 94";17;33;50
"3093";"hualañé";"95 a 99";2;6;8
"3094";"hualañé";"100 o más";2;1;3
"3095";"licantén";"20 a 24";180;156;336
"3096";"licantén";"25 a 29";234;240;474
"3097";"licantén";"30 a 34";192;233;425
"3098";"licantén";"35 a 39";211;209;420
"3099";"licantén";"40 a 44";240;218;458
"3100";"licantén";"45 a 49";242;232;474
"3101";"licantén";"50 a 54";302;284;586
"3102";"licantén";"55 a 59";229;233;462
"3103";"licantén";"60 a 64";201;208;409
"3104";"licantén";"65 a 69";181;150;331
"3105";"licantén";"70 a 74";135;106;241
"3106";"licantén";"75 a 79";94;88;182
"3107";"licantén";"80 a 84";38;59;97
"3108";"licantén";"85 a 89";35;43;78
"3109";"licantén";"90 a 94";11;25;36
"3110";"licantén";"95 a 99";5;9;14
"3111";"licantén";"100 o más";2;3;5
"3112";"molina";"20 a 24";1612;1591;3203
"3113";"molina";"25 a 29";1685;1753;3438
"3114";"molina";"30 a 34";1470;1609;3079
"3115";"molina";"35 a 39";1587;1682;3269
"3116";"molina";"40 a 44";1599;1580;3179
"3117";"molina";"45 a 49";1403;1519;2922
"3118";"molina";"50 a 54";1609;1741;3350
"3119";"molina";"55 a 59";1440;1473;2913
"3120";"molina";"60 a 64";1236;1232;2468
"3121";"molina";"65 a 69";888;1003;1891
"3122";"molina";"70 a 74";693;775;1468
"3123";"molina";"75 a 79";486;527;1013
"3124";"molina";"80 a 84";272;330;602
"3125";"molina";"85 a 89";134;256;390
"3126";"molina";"90 a 94";62;75;137
"3127";"molina";"95 a 99";14;29;43
"3128";"molina";"100 o más";2;6;8
"3129";"rauco";"20 a 24";355;344;699
"3130";"rauco";"25 a 29";388;383;771
"3131";"rauco";"30 a 34";296;330;626
"3132";"rauco";"35 a 39";303;364;667
"3133";"rauco";"40 a 44";369;391;760
"3134";"rauco";"45 a 49";364;389;753
"3135";"rauco";"50 a 54";410;391;801
"3136";"rauco";"55 a 59";316;338;654
"3137";"rauco";"60 a 64";307;266;573
"3138";"rauco";"65 a 69";234;235;469
"3139";"rauco";"70 a 74";180;180;360
"3140";"rauco";"75 a 79";124;141;265
"3141";"rauco";"80 a 84";92;82;174
"3142";"rauco";"85 a 89";37;59;96
"3143";"rauco";"90 a 94";17;26;43
"3144";"rauco";"95 a 99";3;5;8
"3145";"rauco";"100 o más";2;2;4
"3146";"romeral";"20 a 24";486;514;1000
"3147";"romeral";"25 a 29";572;614;1186
"3148";"romeral";"30 a 34";517;495;1012
"3149";"romeral";"35 a 39";499;545;1044
"3150";"romeral";"40 a 44";614;603;1217
"3151";"romeral";"45 a 49";591;529;1120
"3152";"romeral";"50 a 54";581;556;1137
"3153";"romeral";"55 a 59";489;450;939
"3154";"romeral";"60 a 64";387;372;759
"3155";"romeral";"65 a 69";321;297;618
"3156";"romeral";"70 a 74";217;225;442
"3157";"romeral";"75 a 79";166;158;324
"3158";"romeral";"80 a 84";93;106;199
"3159";"romeral";"85 a 89";40;64;104
"3160";"romeral";"90 a 94";21;23;44
"3161";"romeral";"95 a 99";2;6;8
"3162";"romeral";"100 o más";1;0;1
"3163";"sagrada familia";"20 a 24";580;657;1237
"3164";"sagrada familia";"25 a 29";702;694;1396
"3165";"sagrada familia";"30 a 34";632;587;1219
"3166";"sagrada familia";"35 a 39";609;639;1248
"3167";"sagrada familia";"40 a 44";607;661;1268
"3168";"sagrada familia";"45 a 49";686;678;1364
"3169";"sagrada familia";"50 a 54";767;691;1458
"3170";"sagrada familia";"55 a 59";643;605;1248
"3171";"sagrada familia";"60 a 64";553;528;1081
"3172";"sagrada familia";"65 a 69";424;372;796
"3173";"sagrada familia";"70 a 74";324;282;606
"3174";"sagrada familia";"75 a 79";207;208;415
"3175";"sagrada familia";"80 a 84";141;122;263
"3176";"sagrada familia";"85 a 89";73;90;163
"3177";"sagrada familia";"90 a 94";17;24;41
"3178";"sagrada familia";"95 a 99";6;2;8
"3179";"sagrada familia";"100 o más";2;0;2
"3180";"teno";"20 a 24";1025;1019;2044
"3181";"teno";"25 a 29";1141;1062;2203
"3182";"teno";"30 a 34";973;953;1926
"3183";"teno";"35 a 39";911;920;1831
"3184";"teno";"40 a 44";954;944;1898
"3185";"teno";"45 a 49";1065;1050;2115
"3186";"teno";"50 a 54";1205;1120;2325
"3187";"teno";"55 a 59";996;918;1914
"3188";"teno";"60 a 64";787;749;1536
"3189";"teno";"65 a 69";620;566;1186
"3190";"teno";"70 a 74";470;444;914
"3191";"teno";"75 a 79";318;337;655
"3192";"teno";"80 a 84";209;215;424
"3193";"teno";"85 a 89";96;131;227
"3194";"teno";"90 a 94";31;54;85
"3195";"teno";"95 a 99";8;15;23
"3196";"teno";"100 o más";4;1;5
"3197";"vichuquén";"20 a 24";104;88;192
"3198";"vichuquén";"25 a 29";144;150;294
"3199";"vichuquén";"30 a 34";123;123;246
"3200";"vichuquén";"35 a 39";136;114;250
"3201";"vichuquén";"40 a 44";175;143;318
"3202";"vichuquén";"45 a 49";186;172;358
"3203";"vichuquén";"50 a 54";186;188;374
"3204";"vichuquén";"55 a 59";152;155;307
"3205";"vichuquén";"60 a 64";158;142;300
"3206";"vichuquén";"65 a 69";133;92;225
"3207";"vichuquén";"70 a 74";97;109;206
"3208";"vichuquén";"75 a 79";77;55;132
"3209";"vichuquén";"80 a 84";47;49;96
"3210";"vichuquén";"85 a 89";29;31;60
"3211";"vichuquén";"90 a 94";1;11;12
"3212";"vichuquén";"95 a 99";1;2;3
"3213";"vichuquén";"100 o más";0;1;1
"3214";"linares";"20 a 24";2964;2984;5948
"3215";"linares";"25 a 29";3258;3621;6879
"3216";"linares";"30 a 34";3019;3345;6364
"3217";"linares";"35 a 39";2945;3407;6352
"3218";"linares";"40 a 44";2920;3284;6204
"3219";"linares";"45 a 49";2857;3342;6199
"3220";"linares";"50 a 54";3251;3632;6883
"3221";"linares";"55 a 59";2723;3246;5969
"3222";"linares";"60 a 64";2254;2670;4924
"3223";"linares";"65 a 69";1802;2088;3890
"3224";"linares";"70 a 74";1327;1633;2960
"3225";"linares";"75 a 79";918;1244;2162
"3226";"linares";"80 a 84";582;821;1403
"3227";"linares";"85 a 89";319;530;849
"3228";"linares";"90 a 94";105;233;338
"3229";"linares";"95 a 99";23;71;94
"3230";"linares";"100 o más";13;10;23
"3231";"colbún";"20 a 24";684;724;1408
"3232";"colbún";"25 a 29";757;780;1537
"3233";"colbún";"30 a 34";621;734;1355
"3234";"colbún";"35 a 39";625;675;1300
"3235";"colbún";"40 a 44";628;718;1346
"3236";"colbún";"45 a 49";615;731;1346
"3237";"colbún";"50 a 54";730;705;1435
"3238";"colbún";"55 a 59";655;664;1319
"3239";"colbún";"60 a 64";554;595;1149
"3240";"colbún";"65 a 69";518;463;981
"3241";"colbún";"70 a 74";378;362;740
"3242";"colbún";"75 a 79";247;245;492
"3243";"colbún";"80 a 84";142;144;286
"3244";"colbún";"85 a 89";77;113;190
"3245";"colbún";"90 a 94";33;39;72
"3246";"colbún";"95 a 99";6;11;17
"3247";"colbún";"100 o más";2;5;7
"3248";"longaví";"20 a 24";978;974;1952
"3249";"longaví";"25 a 29";1053;1172;2225
"3250";"longaví";"30 a 34";973;974;1947
"3251";"longaví";"35 a 39";966;1022;1988
"3252";"longaví";"40 a 44";1047;1058;2105
"3253";"longaví";"45 a 49";1114;1089;2203
"3254";"longaví";"50 a 54";1232;1186;2418
"3255";"longaví";"55 a 59";1123;978;2101
"3256";"longaví";"60 a 64";878;783;1661
"3257";"longaví";"65 a 69";709;658;1367
"3258";"longaví";"70 a 74";591;526;1117
"3259";"longaví";"75 a 79";363;326;689
"3260";"longaví";"80 a 84";197;205;402
"3261";"longaví";"85 a 89";123;127;250
"3262";"longaví";"90 a 94";42;65;107
"3263";"longaví";"95 a 99";13;18;31
"3264";"longaví";"100 o más";5;3;8
"3265";"parral";"20 a 24";1119;1251;2370
"3266";"parral";"25 a 29";1392;1563;2955
"3267";"parral";"30 a 34";1254;1404;2658
"3268";"parral";"35 a 39";1214;1390;2604
"3269";"parral";"40 a 44";1382;1456;2838
"3270";"parral";"45 a 49";1409;1577;2986
"3271";"parral";"50 a 54";1505;1542;3047
"3272";"parral";"55 a 59";1296;1356;2652
"3273";"parral";"60 a 64";1133;1167;2300
"3274";"parral";"65 a 69";915;878;1793
"3275";"parral";"70 a 74";732;785;1517
"3276";"parral";"75 a 79";496;653;1149
"3277";"parral";"80 a 84";305;410;715
"3278";"parral";"85 a 89";145;265;410
"3279";"parral";"90 a 94";65;96;161
"3280";"parral";"95 a 99";9;33;42
"3281";"parral";"100 o más";3;8;11
"3282";"retiro";"20 a 24";554;616;1170
"3283";"retiro";"25 a 29";607;690;1297
"3284";"retiro";"30 a 34";582;604;1186
"3285";"retiro";"35 a 39";545;622;1167
"3286";"retiro";"40 a 44";692;718;1410
"3287";"retiro";"45 a 49";772;765;1537
"3288";"retiro";"50 a 54";860;783;1643
"3289";"retiro";"55 a 59";748;691;1439
"3290";"retiro";"60 a 64";590;552;1142
"3291";"retiro";"65 a 69";511;431;942
"3292";"retiro";"70 a 74";379;348;727
"3293";"retiro";"75 a 79";256;246;502
"3294";"retiro";"80 a 84";142;163;305
"3295";"retiro";"85 a 89";79;101;180
"3296";"retiro";"90 a 94";30;49;79
"3297";"retiro";"95 a 99";9;10;19
"3298";"retiro";"100 o más";3;4;7
"3299";"san javier";"20 a 24";1604;1745;3349
"3300";"san javier";"25 a 29";1569;1794;3363
"3301";"san javier";"30 a 34";1293;1509;2802
"3302";"san javier";"35 a 39";1263;1426;2689
"3303";"san javier";"40 a 44";1450;1594;3044
"3304";"san javier";"45 a 49";1568;1705;3273
"3305";"san javier";"50 a 54";1572;1604;3176
"3306";"san javier";"55 a 59";1312;1438;2750
"3307";"san javier";"60 a 64";1116;1189;2305
"3308";"san javier";"65 a 69";950;973;1923
"3309";"san javier";"70 a 74";754;819;1573
"3310";"san javier";"75 a 79";541;623;1164
"3311";"san javier";"80 a 84";277;397;674
"3312";"san javier";"85 a 89";166;250;416
"3313";"san javier";"90 a 94";61;115;176
"3314";"san javier";"95 a 99";13;38;51
"3315";"san javier";"100 o más";7;6;13
"3316";"villa alegre";"20 a 24";505;586;1091
"3317";"villa alegre";"25 a 29";500;588;1088
"3318";"villa alegre";"30 a 34";472;554;1026
"3319";"villa alegre";"35 a 39";457;510;967
"3320";"villa alegre";"40 a 44";519;528;1047
"3321";"villa alegre";"45 a 49";561;579;1140
"3322";"villa alegre";"50 a 54";589;611;1200
"3323";"villa alegre";"55 a 59";521;523;1044
"3324";"villa alegre";"60 a 64";456;476;932
"3325";"villa alegre";"65 a 69";355;394;749
"3326";"villa alegre";"70 a 74";336;323;659
"3327";"villa alegre";"75 a 79";223;238;461
"3328";"villa alegre";"80 a 84";129;138;267
"3329";"villa alegre";"85 a 89";69;101;170
"3330";"villa alegre";"90 a 94";29;41;70
"3331";"villa alegre";"95 a 99";4;8;12
"3332";"villa alegre";"100 o más";0;4;4
"3333";"yerbas buenas";"20 a 24";567;612;1179
"3334";"yerbas buenas";"25 a 29";651;626;1277
"3335";"yerbas buenas";"30 a 34";552;597;1149
"3336";"yerbas buenas";"35 a 39";578;604;1182
"3337";"yerbas buenas";"40 a 44";594;624;1218
"3338";"yerbas buenas";"45 a 49";626;684;1310
"3339";"yerbas buenas";"50 a 54";713;669;1382
"3340";"yerbas buenas";"55 a 59";607;536;1143
"3341";"yerbas buenas";"60 a 64";490;515;1005
"3342";"yerbas buenas";"65 a 69";401;365;766
"3343";"yerbas buenas";"70 a 74";339;274;613
"3344";"yerbas buenas";"75 a 79";201;194;395
"3345";"yerbas buenas";"80 a 84";120;101;221
"3346";"yerbas buenas";"85 a 89";58;74;132
"3347";"yerbas buenas";"90 a 94";15;28;43
"3348";"yerbas buenas";"95 a 99";10;11;21
"3349";"yerbas buenas";"100 o más";5;6;11
"3350";"concepción";"20 a 24";13109;12654;25763
"3351";"concepción";"25 a 29";11134;10373;21507
"3352";"concepción";"30 a 34";8116;7934;16050
"3353";"concepción";"35 a 39";6771;7105;13876
"3354";"concepción";"40 a 44";6379;7028;13407
"3355";"concepción";"45 a 49";6540;7218;13758
"3356";"concepción";"50 a 54";6627;7656;14283
"3357";"concepción";"55 a 59";5884;7332;13216
"3358";"concepción";"60 a 64";5105;6240;11345
"3359";"concepción";"65 a 69";3864;4960;8824
"3360";"concepción";"70 a 74";3010;4076;7086
"3361";"concepción";"75 a 79";1975;3097;5072
"3362";"concepción";"80 a 84";1293;2139;3432
"3363";"concepción";"85 a 89";725;1461;2186
"3364";"concepción";"90 a 94";217;693;910
"3365";"concepción";"95 a 99";66;214;280
"3366";"concepción";"100 o más";19;49;68
"3367";"coronel";"20 a 24";4298;4461;8759
"3368";"coronel";"25 a 29";4598;4933;9531
"3369";"coronel";"30 a 34";3820;4274;8094
"3370";"coronel";"35 a 39";3544;3855;7399
"3371";"coronel";"40 a 44";3392;3962;7354
"3372";"coronel";"45 a 49";3653;4257;7910
"3373";"coronel";"50 a 54";3935;4459;8394
"3374";"coronel";"55 a 59";3455;3705;7160
"3375";"coronel";"60 a 64";2677;2989;5666
"3376";"coronel";"65 a 69";1824;2124;3948
"3377";"coronel";"70 a 74";1280;1652;2932
"3378";"coronel";"75 a 79";884;1177;2061
"3379";"coronel";"80 a 84";534;731;1265
"3380";"coronel";"85 a 89";285;536;821
"3381";"coronel";"90 a 94";88;173;261
"3382";"coronel";"95 a 99";17;49;66
"3383";"coronel";"100 o más";6;17;23
"3384";"chiguayante";"20 a 24";3587;3673;7260
"3385";"chiguayante";"25 a 29";3445;3516;6961
"3386";"chiguayante";"30 a 34";2542;2815;5357
"3387";"chiguayante";"35 a 39";2463;2819;5282
"3388";"chiguayante";"40 a 44";2435;2974;5409
"3389";"chiguayante";"45 a 49";2746;3493;6239
"3390";"chiguayante";"50 a 54";2943;3514;6457
"3391";"chiguayante";"55 a 59";2494;2988;5482
"3392";"chiguayante";"60 a 64";1983;2386;4369
"3393";"chiguayante";"65 a 69";1525;1939;3464
"3394";"chiguayante";"70 a 74";1061;1416;2477
"3395";"chiguayante";"75 a 79";691;1042;1733
"3396";"chiguayante";"80 a 84";397;627;1024
"3397";"chiguayante";"85 a 89";198;447;645
"3398";"chiguayante";"90 a 94";70;188;258
"3399";"chiguayante";"95 a 99";27;65;92
"3400";"chiguayante";"100 o más";3;10;13
"3401";"florida";"20 a 24";336;287;623
"3402";"florida";"25 a 29";319;364;683
"3403";"florida";"30 a 34";341;321;662
"3404";"florida";"35 a 39";295;283;578
"3405";"florida";"40 a 44";357;323;680
"3406";"florida";"45 a 49";427;382;809
"3407";"florida";"50 a 54";433;421;854
"3408";"florida";"55 a 59";397;432;829
"3409";"florida";"60 a 64";372;327;699
"3410";"florida";"65 a 69";300;280;580
"3411";"florida";"70 a 74";236;223;459
"3412";"florida";"75 a 79";174;175;349
"3413";"florida";"80 a 84";91;108;199
"3414";"florida";"85 a 89";67;81;148
"3415";"florida";"90 a 94";17;32;49
"3416";"florida";"95 a 99";2;9;11
"3417";"florida";"100 o más";0;1;1
"3418";"hualqui";"20 a 24";897;962;1859
"3419";"hualqui";"25 a 29";894;955;1849
"3420";"hualqui";"30 a 34";751;805;1556
"3421";"hualqui";"35 a 39";763;837;1600
"3422";"hualqui";"40 a 44";715;782;1497
"3423";"hualqui";"45 a 49";785;922;1707
"3424";"hualqui";"50 a 54";873;915;1788
"3425";"hualqui";"55 a 59";720;776;1496
"3426";"hualqui";"60 a 64";581;605;1186
"3427";"hualqui";"65 a 69";412;464;876
"3428";"hualqui";"70 a 74";323;367;690
"3429";"hualqui";"75 a 79";215;280;495
"3430";"hualqui";"80 a 84";159;185;344
"3431";"hualqui";"85 a 89";72;128;200
"3432";"hualqui";"90 a 94";19;51;70
"3433";"hualqui";"95 a 99";2;26;28
"3434";"hualqui";"100 o más";1;5;6
"3435";"lota";"20 a 24";1648;1726;3374
"3436";"lota";"25 a 29";1620;1643;3263
"3437";"lota";"30 a 34";1199;1247;2446
"3438";"lota";"35 a 39";1049;1222;2271
"3439";"lota";"40 a 44";1308;1415;2723
"3440";"lota";"45 a 49";1517;1694;3211
"3441";"lota";"50 a 54";1604;1807;3411
"3442";"lota";"55 a 59";1459;1512;2971
"3443";"lota";"60 a 64";1152;1334;2486
"3444";"lota";"65 a 69";882;991;1873
"3445";"lota";"70 a 74";685;817;1502
"3446";"lota";"75 a 79";426;604;1030
"3447";"lota";"80 a 84";236;355;591
"3448";"lota";"85 a 89";124;241;365
"3449";"lota";"90 a 94";43;93;136
"3450";"lota";"95 a 99";13;19;32
"3451";"lota";"100 o más";2;4;6
"3452";"penco";"20 a 24";1769;1773;3542
"3453";"penco";"25 a 29";1832;1931;3763
"3454";"penco";"30 a 34";1496;1587;3083
"3455";"penco";"35 a 39";1341;1532;2873
"3456";"penco";"40 a 44";1453;1636;3089
"3457";"penco";"45 a 49";1527;1716;3243
"3458";"penco";"50 a 54";1631;1870;3501
"3459";"penco";"55 a 59";1493;1665;3158
"3460";"penco";"60 a 64";1143;1334;2477
"3461";"penco";"65 a 69";939;1077;2016
"3462";"penco";"70 a 74";640;872;1512
"3463";"penco";"75 a 79";422;614;1036
"3464";"penco";"80 a 84";209;349;558
"3465";"penco";"85 a 89";107;249;356
"3466";"penco";"90 a 94";37;85;122
"3467";"penco";"95 a 99";7;36;43
"3468";"penco";"100 o más";5;4;9
"3469";"san pedro de la paz";"20 a 24";4960;5029;9989
"3470";"san pedro de la paz";"25 a 29";4837;5306;10143
"3471";"san pedro de la paz";"30 a 34";4544;5209;9753
"3472";"san pedro de la paz";"35 a 39";4768;5502;10270
"3473";"san pedro de la paz";"40 a 44";4948;5420;10368
"3474";"san pedro de la paz";"45 a 49";4181;4782;8963
"3475";"san pedro de la paz";"50 a 54";3866;4404;8270
"3476";"san pedro de la paz";"55 a 59";3074;3710;6784
"3477";"san pedro de la paz";"60 a 64";2441;3140;5581
"3478";"san pedro de la paz";"65 a 69";1905;2371;4276
"3479";"san pedro de la paz";"70 a 74";1345;1664;3009
"3480";"san pedro de la paz";"75 a 79";796;1189;1985
"3481";"san pedro de la paz";"80 a 84";447;752;1199
"3482";"san pedro de la paz";"85 a 89";215;485;700
"3483";"san pedro de la paz";"90 a 94";65;204;269
"3484";"san pedro de la paz";"95 a 99";20;51;71
"3485";"san pedro de la paz";"100 o más";11;14;25
"3486";"santa juana";"20 a 24";460;488;948
"3487";"santa juana";"25 a 29";462;510;972
"3488";"santa juana";"30 a 34";383;443;826
"3489";"santa juana";"35 a 39";360;443;803
"3490";"santa juana";"40 a 44";419;465;884
"3491";"santa juana";"45 a 49";470;485;955
"3492";"santa juana";"50 a 54";511;504;1015
"3493";"santa juana";"55 a 59";446;462;908
"3494";"santa juana";"60 a 64";366;354;720
"3495";"santa juana";"65 a 69";307;303;610
"3496";"santa juana";"70 a 74";264;277;541
"3497";"santa juana";"75 a 79";199;193;392
"3498";"santa juana";"80 a 84";110;144;254
"3499";"santa juana";"85 a 89";62;77;139
"3500";"santa juana";"90 a 94";25;41;66
"3501";"santa juana";"95 a 99";6;5;11
"3502";"santa juana";"100 o más";1;4;5
"3503";"talcahuano";"20 a 24";6510;6109;12619
"3504";"talcahuano";"25 a 29";6018;6080;12098
"3505";"talcahuano";"30 a 34";4951;5284;10235
"3506";"talcahuano";"35 a 39";4452;4866;9318
"3507";"talcahuano";"40 a 44";4426;5002;9428
"3508";"talcahuano";"45 a 49";4462;5100;9562
"3509";"talcahuano";"50 a 54";4928;5843;10771
"3510";"talcahuano";"55 a 59";4817;5661;10478
"3511";"talcahuano";"60 a 64";3974;4706;8680
"3512";"talcahuano";"65 a 69";2907;3281;6188
"3513";"talcahuano";"70 a 74";1914;2567;4481
"3514";"talcahuano";"75 a 79";1251;1973;3224
"3515";"talcahuano";"80 a 84";837;1394;2231
"3516";"talcahuano";"85 a 89";497;957;1454
"3517";"talcahuano";"90 a 94";139;403;542
"3518";"talcahuano";"95 a 99";36;91;127
"3519";"talcahuano";"100 o más";14;26;40
"3520";"tomé";"20 a 24";1915;2008;3923
"3521";"tomé";"25 a 29";1903;2147;4050
"3522";"tomé";"30 a 34";1640;1844;3484
"3523";"tomé";"35 a 39";1558;1852;3410
"3524";"tomé";"40 a 44";1632;1822;3454
"3525";"tomé";"45 a 49";1778;2105;3883
"3526";"tomé";"50 a 54";1795;2127;3922
"3527";"tomé";"55 a 59";1731;1910;3641
"3528";"tomé";"60 a 64";1332;1638;2970
"3529";"tomé";"65 a 69";1104;1377;2481
"3530";"tomé";"70 a 74";894;1171;2065
"3531";"tomé";"75 a 79";604;856;1460
"3532";"tomé";"80 a 84";375;598;973
"3533";"tomé";"85 a 89";220;349;569
"3534";"tomé";"90 a 94";78;172;250
"3535";"tomé";"95 a 99";22;45;67
"3536";"tomé";"100 o más";10;13;23
"3537";"hualpén";"20 a 24";3883;3768;7651
"3538";"hualpén";"25 a 29";3546;3830;7376
"3539";"hualpén";"30 a 34";2889;3048;5937
"3540";"hualpén";"35 a 39";2692;3069;5761
"3541";"hualpén";"40 a 44";2842;3282;6124
"3542";"hualpén";"45 a 49";2943;3355;6298
"3543";"hualpén";"50 a 54";3137;3654;6791
"3544";"hualpén";"55 a 59";2642;3121;5763
"3545";"hualpén";"60 a 64";2011;2588;4599
"3546";"hualpén";"65 a 69";1592;1958;3550
"3547";"hualpén";"70 a 74";1235;1791;3026
"3548";"hualpén";"75 a 79";939;1390;2329
"3549";"hualpén";"80 a 84";526;892;1418
"3550";"hualpén";"85 a 89";281;564;845
"3551";"hualpén";"90 a 94";61;198;259
"3552";"hualpén";"95 a 99";11;45;56
"3553";"hualpén";"100 o más";4;12;16
"3554";"lebu";"20 a 24";747;817;1564
"3555";"lebu";"25 a 29";906;1011;1917
"3556";"lebu";"30 a 34";878;934;1812
"3557";"lebu";"35 a 39";807;899;1706
"3558";"lebu";"40 a 44";857;946;1803
"3559";"lebu";"45 a 49";872;929;1801
"3560";"lebu";"50 a 54";850;862;1712
"3561";"lebu";"55 a 59";713;759;1472
"3562";"lebu";"60 a 64";629;710;1339
"3563";"lebu";"65 a 69";444;477;921
"3564";"lebu";"70 a 74";337;374;711
"3565";"lebu";"75 a 79";237;271;508
"3566";"lebu";"80 a 84";174;156;330
"3567";"lebu";"85 a 89";97;123;220
"3568";"lebu";"90 a 94";27;51;78
"3569";"lebu";"95 a 99";12;6;18
"3570";"lebu";"100 o más";1;3;4
"3571";"arauco";"20 a 24";1167;1200;2367
"3572";"arauco";"25 a 29";1407;1432;2839
"3573";"arauco";"30 a 34";1232;1293;2525
"3574";"arauco";"35 a 39";1181;1287;2468
"3575";"arauco";"40 a 44";1192;1325;2517
"3576";"arauco";"45 a 49";1268;1358;2626
"3577";"arauco";"50 a 54";1284;1294;2578
"3578";"arauco";"55 a 59";1045;1118;2163
"3579";"arauco";"60 a 64";877;907;1784
"3580";"arauco";"65 a 69";624;699;1323
"3581";"arauco";"70 a 74";495;512;1007
"3582";"arauco";"75 a 79";360;382;742
"3583";"arauco";"80 a 84";186;277;463
"3584";"arauco";"85 a 89";114;179;293
"3585";"arauco";"90 a 94";48;74;122
"3586";"arauco";"95 a 99";8;21;29
"3587";"arauco";"100 o más";4;7;11
"3588";"cañete";"20 a 24";1002;1179;2181
"3589";"cañete";"25 a 29";1192;1315;2507
"3590";"cañete";"30 a 34";1058;1285;2343
"3591";"cañete";"35 a 39";1106;1292;2398
"3592";"cañete";"40 a 44";1138;1240;2378
"3593";"cañete";"45 a 49";1078;1218;2296
"3594";"cañete";"50 a 54";1035;1161;2196
"3595";"cañete";"55 a 59";997;987;1984
"3596";"cañete";"60 a 64";830;834;1664
"3597";"cañete";"65 a 69";684;691;1375
"3598";"cañete";"70 a 74";490;556;1046
"3599";"cañete";"75 a 79";334;395;729
"3600";"cañete";"80 a 84";244;289;533
"3601";"cañete";"85 a 89";135;155;290
"3602";"cañete";"90 a 94";32;87;119
"3603";"cañete";"95 a 99";5;23;28
"3604";"cañete";"100 o más";2;7;9
"3605";"contulmo";"20 a 24";168;183;351
"3606";"contulmo";"25 a 29";194;211;405
"3607";"contulmo";"30 a 34";174;203;377
"3608";"contulmo";"35 a 39";196;231;427
"3609";"contulmo";"40 a 44";203;194;397
"3610";"contulmo";"45 a 49";211;218;429
"3611";"contulmo";"50 a 54";214;203;417
"3612";"contulmo";"55 a 59";213;193;406
"3613";"contulmo";"60 a 64";166;170;336
"3614";"contulmo";"65 a 69";145;113;258
"3615";"contulmo";"70 a 74";111;109;220
"3616";"contulmo";"75 a 79";95;90;185
"3617";"contulmo";"80 a 84";53;55;108
"3618";"contulmo";"85 a 89";34;30;64
"3619";"contulmo";"90 a 94";12;13;25
"3620";"contulmo";"95 a 99";3;4;7
"3621";"contulmo";"100 o más";0;0;0
"3622";"curanilahue";"20 a 24";971;1104;2075
"3623";"curanilahue";"25 a 29";1093;1207;2300
"3624";"curanilahue";"30 a 34";1005;1093;2098
"3625";"curanilahue";"35 a 39";1060;1186;2246
"3626";"curanilahue";"40 a 44";1112;1184;2296
"3627";"curanilahue";"45 a 49";1070;1120;2190
"3628";"curanilahue";"50 a 54";1143;1161;2304
"3629";"curanilahue";"55 a 59";984;1030;2014
"3630";"curanilahue";"60 a 64";875;896;1771
"3631";"curanilahue";"65 a 69";628;629;1257
"3632";"curanilahue";"70 a 74";455;474;929
"3633";"curanilahue";"75 a 79";274;358;632
"3634";"curanilahue";"80 a 84";193;251;444
"3635";"curanilahue";"85 a 89";111;164;275
"3636";"curanilahue";"90 a 94";41;59;100
"3637";"curanilahue";"95 a 99";6;15;21
"3638";"curanilahue";"100 o más";0;7;7
"3639";"los álamos";"20 a 24";580;736;1316
"3640";"los álamos";"25 a 29";708;794;1502
"3641";"los álamos";"30 a 34";620;759;1379
"3642";"los álamos";"35 a 39";692;759;1451
"3643";"los álamos";"40 a 44";723;742;1465
"3644";"los álamos";"45 a 49";702;763;1465
"3645";"los álamos";"50 a 54";682;695;1377
"3646";"los álamos";"55 a 59";583;626;1209
"3647";"los álamos";"60 a 64";476;546;1022
"3648";"los álamos";"65 a 69";380;378;758
"3649";"los álamos";"70 a 74";256;294;550
"3650";"los álamos";"75 a 79";199;177;376
"3651";"los álamos";"80 a 84";121;145;266
"3652";"los álamos";"85 a 89";80;91;171
"3653";"los álamos";"90 a 94";28;38;66
"3654";"los álamos";"95 a 99";10;8;18
"3655";"los álamos";"100 o más";3;4;7
"3656";"tirúa";"20 a 24";360;396;756
"3657";"tirúa";"25 a 29";372;394;766
"3658";"tirúa";"30 a 34";370;385;755
"3659";"tirúa";"35 a 39";403;403;806
"3660";"tirúa";"40 a 44";366;344;710
"3661";"tirúa";"45 a 49";330;336;666
"3662";"tirúa";"50 a 54";314;309;623
"3663";"tirúa";"55 a 59";285;259;544
"3664";"tirúa";"60 a 64";241;234;475
"3665";"tirúa";"65 a 69";174;167;341
"3666";"tirúa";"70 a 74";153;117;270
"3667";"tirúa";"75 a 79";89;78;167
"3668";"tirúa";"80 a 84";64;54;118
"3669";"tirúa";"85 a 89";37;35;72
"3670";"tirúa";"90 a 94";12;15;27
"3671";"tirúa";"95 a 99";2;4;6
"3672";"tirúa";"100 o más";1;1;2
"3673";"los ángeles";"20 a 24";6977;7395;14372
"3674";"los ángeles";"25 a 29";7466;8213;15679
"3675";"los ángeles";"30 a 34";6706;7223;13929
"3676";"los ángeles";"35 a 39";6366;7351;13717
"3677";"los ángeles";"40 a 44";6788;7504;14292
"3678";"los ángeles";"45 a 49";6996;7598;14594
"3679";"los ángeles";"50 a 54";6580;7084;13664
"3680";"los ángeles";"55 a 59";5546;5984;11530
"3681";"los ángeles";"60 a 64";4385;4788;9173
"3682";"los ángeles";"65 a 69";3325;3814;7139
"3683";"los ángeles";"70 a 74";2691;3134;5825
"3684";"los ángeles";"75 a 79";1781;2213;3994
"3685";"los ángeles";"80 a 84";1104;1593;2697
"3686";"los ángeles";"85 a 89";601;965;1566
"3687";"los ángeles";"90 a 94";212;422;634
"3688";"los ángeles";"95 a 99";51;105;156
"3689";"los ángeles";"100 o más";18;30;48
"3690";"antuco";"20 a 24";134;135;269
"3691";"antuco";"25 a 29";113;146;259
"3692";"antuco";"30 a 34";104;133;237
"3693";"antuco";"35 a 39";108;139;247
"3694";"antuco";"40 a 44";112;127;239
"3695";"antuco";"45 a 49";141;142;283
"3696";"antuco";"50 a 54";147;152;299
"3697";"antuco";"55 a 59";120;137;257
"3698";"antuco";"60 a 64";121;119;240
"3699";"antuco";"65 a 69";80;100;180
"3700";"antuco";"70 a 74";84;89;173
"3701";"antuco";"75 a 79";65;69;134
"3702";"antuco";"80 a 84";42;45;87
"3703";"antuco";"85 a 89";21;33;54
"3704";"antuco";"90 a 94";5;16;21
"3705";"antuco";"95 a 99";3;3;6
"3706";"antuco";"100 o más";0;2;2
"3707";"cabrero";"20 a 24";1019;979;1998
"3708";"cabrero";"25 a 29";983;1096;2079
"3709";"cabrero";"30 a 34";882;954;1836
"3710";"cabrero";"35 a 39";890;1018;1908
"3711";"cabrero";"40 a 44";954;1026;1980
"3712";"cabrero";"45 a 49";1048;1132;2180
"3713";"cabrero";"50 a 54";1100;1008;2108
"3714";"cabrero";"55 a 59";879;825;1704
"3715";"cabrero";"60 a 64";739;672;1411
"3716";"cabrero";"65 a 69";557;549;1106
"3717";"cabrero";"70 a 74";438;484;922
"3718";"cabrero";"75 a 79";285;359;644
"3719";"cabrero";"80 a 84";180;212;392
"3720";"cabrero";"85 a 89";104;149;253
"3721";"cabrero";"90 a 94";53;51;104
"3722";"cabrero";"95 a 99";2;17;19
"3723";"cabrero";"100 o más";0;2;2
"3724";"laja";"20 a 24";702;714;1416
"3725";"laja";"25 a 29";699;831;1530
"3726";"laja";"30 a 34";540;688;1228
"3727";"laja";"35 a 39";617;790;1407
"3728";"laja";"40 a 44";648;762;1410
"3729";"laja";"45 a 49";766;861;1627
"3730";"laja";"50 a 54";788;849;1637
"3731";"laja";"55 a 59";684;721;1405
"3732";"laja";"60 a 64";578;669;1247
"3733";"laja";"65 a 69";465;537;1002
"3734";"laja";"70 a 74";409;409;818
"3735";"laja";"75 a 79";261;322;583
"3736";"laja";"80 a 84";159;168;327
"3737";"laja";"85 a 89";85;114;199
"3738";"laja";"90 a 94";22;44;66
"3739";"laja";"95 a 99";4;15;19
"3740";"laja";"100 o más";2;2;4
"3741";"mulchén";"20 a 24";1031;1066;2097
"3742";"mulchén";"25 a 29";1069;1137;2206
"3743";"mulchén";"30 a 34";904;994;1898
"3744";"mulchén";"35 a 39";917;925;1842
"3745";"mulchén";"40 a 44";919;978;1897
"3746";"mulchén";"45 a 49";1023;992;2015
"3747";"mulchén";"50 a 54";1054;1021;2075
"3748";"mulchén";"55 a 59";869;857;1726
"3749";"mulchén";"60 a 64";724;771;1495
"3750";"mulchén";"65 a 69";574;583;1157
"3751";"mulchén";"70 a 74";500;498;998
"3752";"mulchén";"75 a 79";338;429;767
"3753";"mulchén";"80 a 84";196;270;466
"3754";"mulchén";"85 a 89";125;192;317
"3755";"mulchén";"90 a 94";54;71;125
"3756";"mulchén";"95 a 99";9;22;31
"3757";"mulchén";"100 o más";2;1;3
"3758";"nacimiento";"20 a 24";900;908;1808
"3759";"nacimiento";"25 a 29";884;1003;1887
"3760";"nacimiento";"30 a 34";770;852;1622
"3761";"nacimiento";"35 a 39";786;899;1685
"3762";"nacimiento";"40 a 44";812;983;1795
"3763";"nacimiento";"45 a 49";885;922;1807
"3764";"nacimiento";"50 a 54";938;933;1871
"3765";"nacimiento";"55 a 59";875;807;1682
"3766";"nacimiento";"60 a 64";703;679;1382
"3767";"nacimiento";"65 a 69";478;494;972
"3768";"nacimiento";"70 a 74";436;412;848
"3769";"nacimiento";"75 a 79";280;293;573
"3770";"nacimiento";"80 a 84";192;232;424
"3771";"nacimiento";"85 a 89";96;110;206
"3772";"nacimiento";"90 a 94";33;67;100
"3773";"nacimiento";"95 a 99";5;12;17
"3774";"nacimiento";"100 o más";2;7;9
"3775";"negrete";"20 a 24";327;346;673
"3776";"negrete";"25 a 29";340;396;736
"3777";"negrete";"30 a 34";255;320;575
"3778";"negrete";"35 a 39";282;302;584
"3779";"negrete";"40 a 44";282;344;626
"3780";"negrete";"45 a 49";350;343;693
"3781";"negrete";"50 a 54";341;346;687
"3782";"negrete";"55 a 59";343;305;648
"3783";"negrete";"60 a 64";262;220;482
"3784";"negrete";"65 a 69";189;196;385
"3785";"negrete";"70 a 74";174;160;334
"3786";"negrete";"75 a 79";106;135;241
"3787";"negrete";"80 a 84";73;76;149
"3788";"negrete";"85 a 89";40;51;91
"3789";"negrete";"90 a 94";13;20;33
"3790";"negrete";"95 a 99";4;1;5
"3791";"negrete";"100 o más";0;3;3
"3792";"quilaco";"20 a 24";110;136;246
"3793";"quilaco";"25 a 29";128;122;250
"3794";"quilaco";"30 a 34";97;94;191
"3795";"quilaco";"35 a 39";106;119;225
"3796";"quilaco";"40 a 44";109;126;235
"3797";"quilaco";"45 a 49";123;132;255
"3798";"quilaco";"50 a 54";161;137;298
"3799";"quilaco";"55 a 59";147;136;283
"3800";"quilaco";"60 a 64";120;125;245
"3801";"quilaco";"65 a 69";125;116;241
"3802";"quilaco";"70 a 74";102;110;212
"3803";"quilaco";"75 a 79";86;74;160
"3804";"quilaco";"80 a 84";55;52;107
"3805";"quilaco";"85 a 89";28;29;57
"3806";"quilaco";"90 a 94";5;11;16
"3807";"quilaco";"95 a 99";3;5;8
"3808";"quilaco";"100 o más";0;0;0
"3809";"quilleco";"20 a 24";329;319;648
"3810";"quilleco";"25 a 29";283;349;632
"3811";"quilleco";"30 a 34";214;275;489
"3812";"quilleco";"35 a 39";227;263;490
"3813";"quilleco";"40 a 44";301;349;650
"3814";"quilleco";"45 a 49";358;375;733
"3815";"quilleco";"50 a 54";328;331;659
"3816";"quilleco";"55 a 59";335;300;635
"3817";"quilleco";"60 a 64";236;262;498
"3818";"quilleco";"65 a 69";243;244;487
"3819";"quilleco";"70 a 74";240;219;459
"3820";"quilleco";"75 a 79";172;170;342
"3821";"quilleco";"80 a 84";105;86;191
"3822";"quilleco";"85 a 89";63;61;124
"3823";"quilleco";"90 a 94";20;28;48
"3824";"quilleco";"95 a 99";2;7;9
"3825";"quilleco";"100 o más";1;1;2
"3826";"san rosendo";"20 a 24";96;112;208
"3827";"san rosendo";"25 a 29";104;104;208
"3828";"san rosendo";"30 a 34";74;98;172
"3829";"san rosendo";"35 a 39";88;99;187
"3830";"san rosendo";"40 a 44";105;118;223
"3831";"san rosendo";"45 a 49";103;134;237
"3832";"san rosendo";"50 a 54";129;126;255
"3833";"san rosendo";"55 a 59";113;135;248
"3834";"san rosendo";"60 a 64";100;107;207
"3835";"san rosendo";"65 a 69";93;82;175
"3836";"san rosendo";"70 a 74";77;92;169
"3837";"san rosendo";"75 a 79";52;68;120
"3838";"san rosendo";"80 a 84";27;33;60
"3839";"san rosendo";"85 a 89";8;19;27
"3840";"san rosendo";"90 a 94";4;5;9
"3841";"san rosendo";"95 a 99";0;1;1
"3842";"san rosendo";"100 o más";1;1;2
"3843";"santa bárbara";"20 a 24";487;500;987
"3844";"santa bárbara";"25 a 29";479;508;987
"3845";"santa bárbara";"30 a 34";402;480;882
"3846";"santa bárbara";"35 a 39";416;449;865
"3847";"santa bárbara";"40 a 44";364;431;795
"3848";"santa bárbara";"45 a 49";416;452;868
"3849";"santa bárbara";"50 a 54";459;490;949
"3850";"santa bárbara";"55 a 59";407;432;839
"3851";"santa bárbara";"60 a 64";365;366;731
"3852";"santa bárbara";"65 a 69";304;286;590
"3853";"santa bárbara";"70 a 74";247;264;511
"3854";"santa bárbara";"75 a 79";177;194;371
"3855";"santa bárbara";"80 a 84";101;107;208
"3856";"santa bárbara";"85 a 89";80;83;163
"3857";"santa bárbara";"90 a 94";17;40;57
"3858";"santa bárbara";"95 a 99";3;10;13
"3859";"santa bárbara";"100 o más";2;5;7
"3860";"tucapel";"20 a 24";462;471;933
"3861";"tucapel";"25 a 29";399;506;905
"3862";"tucapel";"30 a 34";455;470;925
"3863";"tucapel";"35 a 39";400;452;852
"3864";"tucapel";"40 a 44";387;468;855
"3865";"tucapel";"45 a 49";470;523;993
"3866";"tucapel";"50 a 54";523;467;990
"3867";"tucapel";"55 a 59";462;447;909
"3868";"tucapel";"60 a 64";354;425;779
"3869";"tucapel";"65 a 69";371;330;701
"3870";"tucapel";"70 a 74";240;280;520
"3871";"tucapel";"75 a 79";210;236;446
"3872";"tucapel";"80 a 84";129;150;279
"3873";"tucapel";"85 a 89";71;103;174
"3874";"tucapel";"90 a 94";26;41;67
"3875";"tucapel";"95 a 99";3;15;18
"3876";"tucapel";"100 o más";1;2;3
"3877";"yumbel";"20 a 24";592;575;1167
"3878";"yumbel";"25 a 29";639;690;1329
"3879";"yumbel";"30 a 34";593;647;1240
"3880";"yumbel";"35 a 39";664;696;1360
"3881";"yumbel";"40 a 44";722;701;1423
"3882";"yumbel";"45 a 49";760;840;1600
"3883";"yumbel";"50 a 54";779;782;1561
"3884";"yumbel";"55 a 59";752;751;1503
"3885";"yumbel";"60 a 64";638;614;1252
"3886";"yumbel";"65 a 69";544;542;1086
"3887";"yumbel";"70 a 74";424;472;896
"3888";"yumbel";"75 a 79";359;420;779
"3889";"yumbel";"80 a 84";189;231;420
"3890";"yumbel";"85 a 89";103;163;266
"3891";"yumbel";"90 a 94";51;59;110
"3892";"yumbel";"95 a 99";5;23;28
"3893";"yumbel";"100 o más";0;6;6
"3894";"alto biobío";"20 a 24";204;234;438
"3895";"alto biobío";"25 a 29";248;251;499
"3896";"alto biobío";"30 a 34";253;225;478
"3897";"alto biobío";"35 a 39";214;184;398
"3898";"alto biobío";"40 a 44";207;183;390
"3899";"alto biobío";"45 a 49";181;163;344
"3900";"alto biobío";"50 a 54";181;142;323
"3901";"alto biobío";"55 a 59";153;131;284
"3902";"alto biobío";"60 a 64";118;99;217
"3903";"alto biobío";"65 a 69";91;78;169
"3904";"alto biobío";"70 a 74";64;43;107
"3905";"alto biobío";"75 a 79";52;39;91
"3906";"alto biobío";"80 a 84";34;22;56
"3907";"alto biobío";"85 a 89";9;13;22
"3908";"alto biobío";"90 a 94";2;5;7
"3909";"alto biobío";"95 a 99";1;0;1
"3910";"alto biobío";"100 o más";0;2;2
"3911";"chillán *";"20 a 24";6793;7227;14020
"3912";"chillán *";"25 a 29";6815;7252;14067
"3913";"chillán *";"30 a 34";5976;6678;12654
"3914";"chillán *";"35 a 39";5637;6413;12050
"3915";"chillán *";"40 a 44";5786;6699;12485
"3916";"chillán *";"45 a 49";6057;7038;13095
"3917";"chillán *";"50 a 54";6026;6933;12959
"3918";"chillán *";"55 a 59";5196;6178;11374
"3919";"chillán *";"60 a 64";4257;5071;9328
"3920";"chillán *";"65 a 69";3269;4086;7355
"3921";"chillán *";"70 a 74";2507;3311;5818
"3922";"chillán *";"75 a 79";1696;2494;4190
"3923";"chillán *";"80 a 84";988;1630;2618
"3924";"chillán *";"85 a 89";548;1046;1594
"3925";"chillán *";"90 a 94";196;465;661
"3926";"chillán *";"95 a 99";37;113;150
"3927";"chillán *";"100 o más";11;38;49
"3928";"bulnes *";"20 a 24";691;726;1417
"3929";"bulnes *";"25 a 29";677;785;1462
"3930";"bulnes *";"30 a 34";597;668;1265
"3931";"bulnes *";"35 a 39";617;701;1318
"3932";"bulnes *";"40 a 44";660;773;1433
"3933";"bulnes *";"45 a 49";726;829;1555
"3934";"bulnes *";"50 a 54";831;779;1610
"3935";"bulnes *";"55 a 59";698;770;1468
"3936";"bulnes *";"60 a 64";597;625;1222
"3937";"bulnes *";"65 a 69";502;510;1012
"3938";"bulnes *";"70 a 74";368;419;787
"3939";"bulnes *";"75 a 79";259;292;551
"3940";"bulnes *";"80 a 84";167;214;381
"3941";"bulnes *";"85 a 89";67;106;173
"3942";"bulnes *";"90 a 94";39;56;95
"3943";"bulnes *";"95 a 99";12;9;21
"3944";"bulnes *";"100 o más";1;4;5
"3945";"cobquecura *";"20 a 24";105;117;222
"3946";"cobquecura *";"25 a 29";133;156;289
"3947";"cobquecura *";"30 a 34";150;160;310
"3948";"cobquecura *";"35 a 39";179;158;337
"3949";"cobquecura *";"40 a 44";180;179;359
"3950";"cobquecura *";"45 a 49";172;177;349
"3951";"cobquecura *";"50 a 54";215;186;401
"3952";"cobquecura *";"55 a 59";219;213;432
"3953";"cobquecura *";"60 a 64";174;153;327
"3954";"cobquecura *";"65 a 69";169;145;314
"3955";"cobquecura *";"70 a 74";146;115;261
"3956";"cobquecura *";"75 a 79";103;110;213
"3957";"cobquecura *";"80 a 84";65;57;122
"3958";"cobquecura *";"85 a 89";31;36;67
"3959";"cobquecura *";"90 a 94";7;17;24
"3960";"cobquecura *";"95 a 99";2;10;12
"3961";"cobquecura *";"100 o más";0;2;2
"3962";"coelemu *";"20 a 24";512;509;1021
"3963";"coelemu *";"25 a 29";523;566;1089
"3964";"coelemu *";"30 a 34";438;490;928
"3965";"coelemu *";"35 a 39";449;511;960
"3966";"coelemu *";"40 a 44";507;559;1066
"3967";"coelemu *";"45 a 49";557;526;1083
"3968";"coelemu *";"50 a 54";629;619;1248
"3969";"coelemu *";"55 a 59";568;568;1136
"3970";"coelemu *";"60 a 64";459;473;932
"3971";"coelemu *";"65 a 69";357;381;738
"3972";"coelemu *";"70 a 74";296;336;632
"3973";"coelemu *";"75 a 79";199;208;407
"3974";"coelemu *";"80 a 84";125;160;285
"3975";"coelemu *";"85 a 89";71;110;181
"3976";"coelemu *";"90 a 94";34;59;93
"3977";"coelemu *";"95 a 99";5;7;12
"3978";"coelemu *";"100 o más";5;3;8
"3979";"coihueco *";"20 a 24";992;986;1978
"3980";"coihueco *";"25 a 29";956;989;1945
"3981";"coihueco *";"30 a 34";820;941;1761
"3982";"coihueco *";"35 a 39";852;886;1738
"3983";"coihueco *";"40 a 44";905;958;1863
"3984";"coihueco *";"45 a 49";974;1046;2020
"3985";"coihueco *";"50 a 54";966;936;1902
"3986";"coihueco *";"55 a 59";872;788;1660
"3987";"coihueco *";"60 a 64";675;635;1310
"3988";"coihueco *";"65 a 69";542;452;994
"3989";"coihueco *";"70 a 74";407;403;810
"3990";"coihueco *";"75 a 79";285;302;587
"3991";"coihueco *";"80 a 84";180;193;373
"3992";"coihueco *";"85 a 89";88;115;203
"3993";"coihueco *";"90 a 94";37;51;88
"3994";"coihueco *";"95 a 99";7;10;17
"3995";"coihueco *";"100 o más";2;4;6
"3996";"chillán viejo *";"20 a 24";1053;1194;2247
"3997";"chillán viejo *";"25 a 29";1127;1273;2400
"3998";"chillán viejo *";"30 a 34";1033;1194;2227
"3999";"chillán viejo *";"35 a 39";942;1177;2119
"4000";"chillán viejo *";"40 a 44";1060;1266;2326
"4001";"chillán viejo *";"45 a 49";1055;1244;2299
"4002";"chillán viejo *";"50 a 54";1000;1128;2128
"4003";"chillán viejo *";"55 a 59";778;822;1600
"4004";"chillán viejo *";"60 a 64";612;717;1329
"4005";"chillán viejo *";"65 a 69";458;562;1020
"4006";"chillán viejo *";"70 a 74";346;431;777
"4007";"chillán viejo *";"75 a 79";236;314;550
"4008";"chillán viejo *";"80 a 84";126;177;303
"4009";"chillán viejo *";"85 a 89";50;123;173
"4010";"chillán viejo *";"90 a 94";23;47;70
"4011";"chillán viejo *";"95 a 99";5;18;23
"4012";"chillán viejo *";"100 o más";3;5;8
"4013";"el carmen *";"20 a 24";345;385;730
"4014";"el carmen *";"25 a 29";370;364;734
"4015";"el carmen *";"30 a 34";344;379;723
"4016";"el carmen *";"35 a 39";371;401;772
"4017";"el carmen *";"40 a 44";416;429;845
"4018";"el carmen *";"45 a 49";425;433;858
"4019";"el carmen *";"50 a 54";466;471;937
"4020";"el carmen *";"55 a 59";414;363;777
"4021";"el carmen *";"60 a 64";339;331;670
"4022";"el carmen *";"65 a 69";281;272;553
"4023";"el carmen *";"70 a 74";223;269;492
"4024";"el carmen *";"75 a 79";179;226;405
"4025";"el carmen *";"80 a 84";126;117;243
"4026";"el carmen *";"85 a 89";59;86;145
"4027";"el carmen *";"90 a 94";19;38;57
"4028";"el carmen *";"95 a 99";1;12;13
"4029";"el carmen *";"100 o más";0;2;2
"4030";"ninhue *";"20 a 24";125;129;254
"4031";"ninhue *";"25 a 29";137;150;287
"4032";"ninhue *";"30 a 34";121;154;275
"4033";"ninhue *";"35 a 39";145;166;311
"4034";"ninhue *";"40 a 44";175;164;339
"4035";"ninhue *";"45 a 49";180;210;390
"4036";"ninhue *";"50 a 54";217;217;434
"4037";"ninhue *";"55 a 59";187;194;381
"4038";"ninhue *";"60 a 64";189;151;340
"4039";"ninhue *";"65 a 69";157;157;314
"4040";"ninhue *";"70 a 74";117;122;239
"4041";"ninhue *";"75 a 79";106;89;195
"4042";"ninhue *";"80 a 84";58;71;129
"4043";"ninhue *";"85 a 89";28;41;69
"4044";"ninhue *";"90 a 94";13;20;33
"4045";"ninhue *";"95 a 99";4;3;7
"4046";"ninhue *";"100 o más";0;1;1
"4047";"ñiquén *";"20 a 24";279;278;557
"4048";"ñiquén *";"25 a 29";281;330;611
"4049";"ñiquén *";"30 a 34";276;320;596
"4050";"ñiquén *";"35 a 39";273;339;612
"4051";"ñiquén *";"40 a 44";345;346;691
"4052";"ñiquén *";"45 a 49";407;422;829
"4053";"ñiquén *";"50 a 54";484;447;931
"4054";"ñiquén *";"55 a 59";481;371;852
"4055";"ñiquén *";"60 a 64";413;367;780
"4056";"ñiquén *";"65 a 69";330;296;626
"4057";"ñiquén *";"70 a 74";291;253;544
"4058";"ñiquén *";"75 a 79";170;193;363
"4059";"ñiquén *";"80 a 84";113;132;245
"4060";"ñiquén *";"85 a 89";73;80;153
"4061";"ñiquén *";"90 a 94";19;30;49
"4062";"ñiquén *";"95 a 99";10;11;21
"4063";"ñiquén *";"100 o más";2;2;4
"4064";"pemuco *";"20 a 24";275;284;559
"4065";"pemuco *";"25 a 29";251;287;538
"4066";"pemuco *";"30 a 34";256;267;523
"4067";"pemuco *";"35 a 39";248;278;526
"4068";"pemuco *";"40 a 44";278;307;585
"4069";"pemuco *";"45 a 49";279;282;561
"4070";"pemuco *";"50 a 54";332;319;651
"4071";"pemuco *";"55 a 59";290;269;559
"4072";"pemuco *";"60 a 64";216;243;459
"4073";"pemuco *";"65 a 69";150;163;313
"4074";"pemuco *";"70 a 74";167;154;321
"4075";"pemuco *";"75 a 79";135;118;253
"4076";"pemuco *";"80 a 84";67;84;151
"4077";"pemuco *";"85 a 89";39;47;86
"4078";"pemuco *";"90 a 94";11;26;37
"4079";"pemuco *";"95 a 99";4;7;11
"4080";"pemuco *";"100 o más";2;1;3
"4081";"pinto *";"20 a 24";341;343;684
"4082";"pinto *";"25 a 29";356;423;779
"4083";"pinto *";"30 a 34";333;341;674
"4084";"pinto *";"35 a 39";293;328;621
"4085";"pinto *";"40 a 44";370;370;740
"4086";"pinto *";"45 a 49";418;437;855
"4087";"pinto *";"50 a 54";414;414;828
"4088";"pinto *";"55 a 59";373;391;764
"4089";"pinto *";"60 a 64";311;294;605
"4090";"pinto *";"65 a 69";252;254;506
"4091";"pinto *";"70 a 74";213;227;440
"4092";"pinto *";"75 a 79";156;164;320
"4093";"pinto *";"80 a 84";81;100;181
"4094";"pinto *";"85 a 89";46;63;109
"4095";"pinto *";"90 a 94";11;23;34
"4096";"pinto *";"95 a 99";7;3;10
"4097";"pinto *";"100 o más";1;3;4
"4098";"portezuelo *";"20 a 24";130;123;253
"4099";"portezuelo *";"25 a 29";123;138;261
"4100";"portezuelo *";"30 a 34";125;129;254
"4101";"portezuelo *";"35 a 39";135;129;264
"4102";"portezuelo *";"40 a 44";145;163;308
"4103";"portezuelo *";"45 a 49";174;190;364
"4104";"portezuelo *";"50 a 54";231;201;432
"4105";"portezuelo *";"55 a 59";211;177;388
"4106";"portezuelo *";"60 a 64";162;147;309
"4107";"portezuelo *";"65 a 69";123;110;233
"4108";"portezuelo *";"70 a 74";95;127;222
"4109";"portezuelo *";"75 a 79";80;93;173
"4110";"portezuelo *";"80 a 84";66;62;128
"4111";"portezuelo *";"85 a 89";26;32;58
"4112";"portezuelo *";"90 a 94";12;15;27
"4113";"portezuelo *";"95 a 99";0;2;2
"4114";"portezuelo *";"100 o más";1;1;2
"4115";"quillón *";"20 a 24";485;525;1010
"4116";"quillón *";"25 a 29";606;579;1185
"4117";"quillón *";"30 a 34";504;547;1051
"4118";"quillón *";"35 a 39";490;514;1004
"4119";"quillón *";"40 a 44";531;563;1094
"4120";"quillón *";"45 a 49";633;625;1258
"4121";"quillón *";"50 a 54";693;653;1346
"4122";"quillón *";"55 a 59";622;625;1247
"4123";"quillón *";"60 a 64";522;571;1093
"4124";"quillón *";"65 a 69";453;480;933
"4125";"quillón *";"70 a 74";408;386;794
"4126";"quillón *";"75 a 79";298;301;599
"4127";"quillón *";"80 a 84";145;205;350
"4128";"quillón *";"85 a 89";86;132;218
"4129";"quillón *";"90 a 94";20;48;68
"4130";"quillón *";"95 a 99";3;15;18
"4131";"quillón *";"100 o más";3;4;7
"4132";"quirihue *";"20 a 24";308;320;628
"4133";"quirihue *";"25 a 29";397;415;812
"4134";"quirihue *";"30 a 34";356;411;767
"4135";"quirihue *";"35 a 39";337;380;717
"4136";"quirihue *";"40 a 44";387;423;810
"4137";"quirihue *";"45 a 49";442;403;845
"4138";"quirihue *";"50 a 54";444;412;856
"4139";"quirihue *";"55 a 59";370;405;775
"4140";"quirihue *";"60 a 64";361;326;687
"4141";"quirihue *";"65 a 69";264;280;544
"4142";"quirihue *";"70 a 74";232;221;453
"4143";"quirihue *";"75 a 79";166;204;370
"4144";"quirihue *";"80 a 84";99;121;220
"4145";"quirihue *";"85 a 89";59;112;171
"4146";"quirihue *";"90 a 94";22;39;61
"4147";"quirihue *";"95 a 99";4;14;18
"4148";"quirihue *";"100 o más";0;3;3
"4149";"ránquil *";"20 a 24";153;151;304
"4150";"ránquil *";"25 a 29";133;159;292
"4151";"ránquil *";"30 a 34";145;169;314
"4152";"ránquil *";"35 a 39";167;170;337
"4153";"ránquil *";"40 a 44";174;181;355
"4154";"ránquil *";"45 a 49";207;191;398
"4155";"ránquil *";"50 a 54";242;226;468
"4156";"ránquil *";"55 a 59";228;240;468
"4157";"ránquil *";"60 a 64";185;211;396
"4158";"ránquil *";"65 a 69";161;164;325
"4159";"ránquil *";"70 a 74";140;131;271
"4160";"ránquil *";"75 a 79";116;126;242
"4161";"ránquil *";"80 a 84";62;77;139
"4162";"ránquil *";"85 a 89";37;51;88
"4163";"ránquil *";"90 a 94";8;20;28
"4164";"ránquil *";"95 a 99";2;6;8
"4165";"ránquil *";"100 o más";0;1;1
"4166";"san carlos *";"20 a 24";1722;1864;3586
"4167";"san carlos *";"25 a 29";1766;1957;3723
"4168";"san carlos *";"30 a 34";1519;1817;3336
"4169";"san carlos *";"35 a 39";1431;1639;3070
"4170";"san carlos *";"40 a 44";1545;1887;3432
"4171";"san carlos *";"45 a 49";1857;2026;3883
"4172";"san carlos *";"50 a 54";1895;2092;3987
"4173";"san carlos *";"55 a 59";1731;1841;3572
"4174";"san carlos *";"60 a 64";1385;1448;2833
"4175";"san carlos *";"65 a 69";1174;1238;2412
"4176";"san carlos *";"70 a 74";937;1014;1951
"4177";"san carlos *";"75 a 79";641;808;1449
"4178";"san carlos *";"80 a 84";402;487;889
"4179";"san carlos *";"85 a 89";210;321;531
"4180";"san carlos *";"90 a 94";88;144;232
"4181";"san carlos *";"95 a 99";16;50;66
"4182";"san carlos *";"100 o más";4;11;15
"4183";"san fabián *";"20 a 24";136;125;261
"4184";"san fabián *";"25 a 29";144;166;310
"4185";"san fabián *";"30 a 34";126;143;269
"4186";"san fabián *";"35 a 39";150;148;298
"4187";"san fabián *";"40 a 44";147;129;276
"4188";"san fabián *";"45 a 49";168;148;316
"4189";"san fabián *";"50 a 54";159;129;288
"4190";"san fabián *";"55 a 59";134;122;256
"4191";"san fabián *";"60 a 64";119;109;228
"4192";"san fabián *";"65 a 69";112;116;228
"4193";"san fabián *";"70 a 74";95;86;181
"4194";"san fabián *";"75 a 79";85;82;167
"4195";"san fabián *";"80 a 84";33;50;83
"4196";"san fabián *";"85 a 89";25;24;49
"4197";"san fabián *";"90 a 94";8;15;23
"4198";"san fabián *";"95 a 99";1;3;4
"4199";"san fabián *";"100 o más";0;2;2
"4200";"san ignacio *";"20 a 24";480;560;1040
"4201";"san ignacio *";"25 a 29";525;522;1047
"4202";"san ignacio *";"30 a 34";465;479;944
"4203";"san ignacio *";"35 a 39";437;477;914
"4204";"san ignacio *";"40 a 44";515;569;1084
"4205";"san ignacio *";"45 a 49";549;625;1174
"4206";"san ignacio *";"50 a 54";626;632;1258
"4207";"san ignacio *";"55 a 59";595;549;1144
"4208";"san ignacio *";"60 a 64";501;497;998
"4209";"san ignacio *";"65 a 69";386;364;750
"4210";"san ignacio *";"70 a 74";316;300;616
"4211";"san ignacio *";"75 a 79";217;231;448
"4212";"san ignacio *";"80 a 84";125;156;281
"4213";"san ignacio *";"85 a 89";81;105;186
"4214";"san ignacio *";"90 a 94";31;41;72
"4215";"san ignacio *";"95 a 99";7;16;23
"4216";"san ignacio *";"100 o más";1;3;4
"4217";"san nicolás *";"20 a 24";332;366;698
"4218";"san nicolás *";"25 a 29";354;373;727
"4219";"san nicolás *";"30 a 34";327;350;677
"4220";"san nicolás *";"35 a 39";327;379;706
"4221";"san nicolás *";"40 a 44";390;429;819
"4222";"san nicolás *";"45 a 49";459;444;903
"4223";"san nicolás *";"50 a 54";485;444;929
"4224";"san nicolás *";"55 a 59";391;380;771
"4225";"san nicolás *";"60 a 64";367;346;713
"4226";"san nicolás *";"65 a 69";292;289;581
"4227";"san nicolás *";"70 a 74";236;227;463
"4228";"san nicolás *";"75 a 79";149;163;312
"4229";"san nicolás *";"80 a 84";78;104;182
"4230";"san nicolás *";"85 a 89";52;57;109
"4231";"san nicolás *";"90 a 94";12;23;35
"4232";"san nicolás *";"95 a 99";4;5;9
"4233";"san nicolás *";"100 o más";0;1;1
"4234";"treguaco *";"20 a 24";132;145;277
"4235";"treguaco *";"25 a 29";154;171;325
"4236";"treguaco *";"30 a 34";123;166;289
"4237";"treguaco *";"35 a 39";136;181;317
"4238";"treguaco *";"40 a 44";199;197;396
"4239";"treguaco *";"45 a 49";212;218;430
"4240";"treguaco *";"50 a 54";231;196;427
"4241";"treguaco *";"55 a 59";196;192;388
"4242";"treguaco *";"60 a 64";175;174;349
"4243";"treguaco *";"65 a 69";147;129;276
"4244";"treguaco *";"70 a 74";113;106;219
"4245";"treguaco *";"75 a 79";99;89;188
"4246";"treguaco *";"80 a 84";52;52;104
"4247";"treguaco *";"85 a 89";26;41;67
"4248";"treguaco *";"90 a 94";3;20;23
"4249";"treguaco *";"95 a 99";2;2;4
"4250";"treguaco *";"100 o más";0;1;1
"4251";"yungay *";"20 a 24";527;530;1057
"4252";"yungay *";"25 a 29";636;663;1299
"4253";"yungay *";"30 a 34";564;488;1052
"4254";"yungay *";"35 a 39";537;576;1113
"4255";"yungay *";"40 a 44";652;636;1288
"4256";"yungay *";"45 a 49";688;703;1391
"4257";"yungay *";"50 a 54";744;649;1393
"4258";"yungay *";"55 a 59";602;547;1149
"4259";"yungay *";"60 a 64";460;480;940
"4260";"yungay *";"65 a 69";398;388;786
"4261";"yungay *";"70 a 74";291;313;604
"4262";"yungay *";"75 a 79";258;268;526
"4263";"yungay *";"80 a 84";158;199;357
"4264";"yungay *";"85 a 89";85;124;209
"4265";"yungay *";"90 a 94";22;57;79
"4266";"yungay *";"95 a 99";2;21;23
"4267";"yungay *";"100 o más";7;1;8
"4268";"temuco";"20 a 24";13276;13772;27048
"4269";"temuco";"25 a 29";11974;12340;24314
"4270";"temuco";"30 a 34";9766;10513;20279
"4271";"temuco";"35 a 39";9011;9855;18866
"4272";"temuco";"40 a 44";9013;10249;19262
"4273";"temuco";"45 a 49";8455;9862;18317
"4274";"temuco";"50 a 54";8221;9640;17861
"4275";"temuco";"55 a 59";7062;8307;15369
"4276";"temuco";"60 a 64";5690;6889;12579
"4277";"temuco";"65 a 69";4264;5479;9743
"4278";"temuco";"70 a 74";3209;4433;7642
"4279";"temuco";"75 a 79";2220;3360;5580
"4280";"temuco";"80 a 84";1369;2408;3777
"4281";"temuco";"85 a 89";763;1656;2419
"4282";"temuco";"90 a 94";303;684;987
"4283";"temuco";"95 a 99";70;217;287
"4284";"temuco";"100 o más";33;53;86
"4285";"carahue";"20 a 24";683;773;1456
"4286";"carahue";"25 a 29";761;902;1663
"4287";"carahue";"30 a 34";715;782;1497
"4288";"carahue";"35 a 39";695;773;1468
"4289";"carahue";"40 a 44";784;732;1516
"4290";"carahue";"45 a 49";811;822;1633
"4291";"carahue";"50 a 54";857;772;1629
"4292";"carahue";"55 a 59";806;701;1507
"4293";"carahue";"60 a 64";661;670;1331
"4294";"carahue";"65 a 69";549;536;1085
"4295";"carahue";"70 a 74";451;467;918
"4296";"carahue";"75 a 79";348;380;728
"4297";"carahue";"80 a 84";188;279;467
"4298";"carahue";"85 a 89";113;146;259
"4299";"carahue";"90 a 94";39;65;104
"4300";"carahue";"95 a 99";14;16;30
"4301";"carahue";"100 o más";3;7;10
"4302";"cunco";"20 a 24";514;533;1047
"4303";"cunco";"25 a 29";528;564;1092
"4304";"cunco";"30 a 34";461;488;949
"4305";"cunco";"35 a 39";442;475;917
"4306";"cunco";"40 a 44";583;594;1177
"4307";"cunco";"45 a 49";617;615;1232
"4308";"cunco";"50 a 54";660;545;1205
"4309";"cunco";"55 a 59";641;530;1171
"4310";"cunco";"60 a 64";517;536;1053
"4311";"cunco";"65 a 69";428;470;898
"4312";"cunco";"70 a 74";410;386;796
"4313";"cunco";"75 a 79";309;303;612
"4314";"cunco";"80 a 84";180;215;395
"4315";"cunco";"85 a 89";89;136;225
"4316";"cunco";"90 a 94";30;66;96
"4317";"cunco";"95 a 99";7;18;25
"4318";"cunco";"100 o más";2;6;8
"4319";"curarrehue";"20 a 24";229;266;495
"4320";"curarrehue";"25 a 29";275;274;549
"4321";"curarrehue";"30 a 34";265;265;530
"4322";"curarrehue";"35 a 39";273;237;510
"4323";"curarrehue";"40 a 44";252;229;481
"4324";"curarrehue";"45 a 49";243;242;485
"4325";"curarrehue";"50 a 54";242;235;477
"4326";"curarrehue";"55 a 59";187;190;377
"4327";"curarrehue";"60 a 64";206;161;367
"4328";"curarrehue";"65 a 69";143;162;305
"4329";"curarrehue";"70 a 74";110;115;225
"4330";"curarrehue";"75 a 79";109;87;196
"4331";"curarrehue";"80 a 84";72;57;129
"4332";"curarrehue";"85 a 89";37;22;59
"4333";"curarrehue";"90 a 94";10;17;27
"4334";"curarrehue";"95 a 99";2;1;3
"4335";"curarrehue";"100 o más";1;2;3
"4336";"freire";"20 a 24";843;851;1694
"4337";"freire";"25 a 29";815;794;1609
"4338";"freire";"30 a 34";677;733;1410
"4339";"freire";"35 a 39";666;722;1388
"4340";"freire";"40 a 44";848;840;1688
"4341";"freire";"45 a 49";892;898;1790
"4342";"freire";"50 a 54";894;865;1759
"4343";"freire";"55 a 59";848;777;1625
"4344";"freire";"60 a 64";724;667;1391
"4345";"freire";"65 a 69";546;516;1062
"4346";"freire";"70 a 74";454;457;911
"4347";"freire";"75 a 79";310;357;667
"4348";"freire";"80 a 84";195;264;459
"4349";"freire";"85 a 89";97;153;250
"4350";"freire";"90 a 94";37;51;88
"4351";"freire";"95 a 99";10;19;29
"4352";"freire";"100 o más";2;4;6
"4353";"galvarino";"20 a 24";388;409;797
"4354";"galvarino";"25 a 29";352;415;767
"4355";"galvarino";"30 a 34";342;375;717
"4356";"galvarino";"35 a 39";368;367;735
"4357";"galvarino";"40 a 44";369;356;725
"4358";"galvarino";"45 a 49";386;389;775
"4359";"galvarino";"50 a 54";451;395;846
"4360";"galvarino";"55 a 59";410;381;791
"4361";"galvarino";"60 a 64";316;285;601
"4362";"galvarino";"65 a 69";259;235;494
"4363";"galvarino";"70 a 74";209;223;432
"4364";"galvarino";"75 a 79";142;197;339
"4365";"galvarino";"80 a 84";116;122;238
"4366";"galvarino";"85 a 89";70;74;144
"4367";"galvarino";"90 a 94";30;40;70
"4368";"galvarino";"95 a 99";8;9;17
"4369";"galvarino";"100 o más";1;4;5
"4370";"gorbea";"20 a 24";432;539;971
"4371";"gorbea";"25 a 29";448;526;974
"4372";"gorbea";"30 a 34";429;434;863
"4373";"gorbea";"35 a 39";407;445;852
"4374";"gorbea";"40 a 44";429;442;871
"4375";"gorbea";"45 a 49";483;541;1024
"4376";"gorbea";"50 a 54";517;538;1055
"4377";"gorbea";"55 a 59";497;475;972
"4378";"gorbea";"60 a 64";418;405;823
"4379";"gorbea";"65 a 69";341;338;679
"4380";"gorbea";"70 a 74";292;334;626
"4381";"gorbea";"75 a 79";211;281;492
"4382";"gorbea";"80 a 84";138;159;297
"4383";"gorbea";"85 a 89";78;118;196
"4384";"gorbea";"90 a 94";30;64;94
"4385";"gorbea";"95 a 99";7;20;27
"4386";"gorbea";"100 o más";1;5;6
"4387";"lautaro";"20 a 24";1412;1522;2934
"4388";"lautaro";"25 a 29";1384;1486;2870
"4389";"lautaro";"30 a 34";1205;1342;2547
"4390";"lautaro";"35 a 39";1179;1206;2385
"4391";"lautaro";"40 a 44";1305;1364;2669
"4392";"lautaro";"45 a 49";1247;1361;2608
"4393";"lautaro";"50 a 54";1161;1216;2377
"4394";"lautaro";"55 a 59";981;1113;2094
"4395";"lautaro";"60 a 64";845;920;1765
"4396";"lautaro";"65 a 69";666;693;1359
"4397";"lautaro";"70 a 74";553;649;1202
"4398";"lautaro";"75 a 79";369;470;839
"4399";"lautaro";"80 a 84";234;321;555
"4400";"lautaro";"85 a 89";128;202;330
"4401";"lautaro";"90 a 94";45;81;126
"4402";"lautaro";"95 a 99";10;26;36
"4403";"lautaro";"100 o más";5;3;8
"4404";"loncoche";"20 a 24";676;731;1407
"4405";"loncoche";"25 a 29";729;770;1499
"4406";"loncoche";"30 a 34";652;787;1439
"4407";"loncoche";"35 a 39";649;791;1440
"4408";"loncoche";"40 a 44";780;797;1577
"4409";"loncoche";"45 a 49";766;757;1523
"4410";"loncoche";"50 a 54";852;880;1732
"4411";"loncoche";"55 a 59";739;775;1514
"4412";"loncoche";"60 a 64";639;639;1278
"4413";"loncoche";"65 a 69";539;588;1127
"4414";"loncoche";"70 a 74";412;436;848
"4415";"loncoche";"75 a 79";304;355;659
"4416";"loncoche";"80 a 84";189;270;459
"4417";"loncoche";"85 a 89";118;148;266
"4418";"loncoche";"90 a 94";44;63;107
"4419";"loncoche";"95 a 99";8;27;35
"4420";"loncoche";"100 o más";3;4;7
"4421";"melipeuco";"20 a 24";183;188;371
"4422";"melipeuco";"25 a 29";182;201;383
"4423";"melipeuco";"30 a 34";181;189;370
"4424";"melipeuco";"35 a 39";177;170;347
"4425";"melipeuco";"40 a 44";215;212;427
"4426";"melipeuco";"45 a 49";184;235;419
"4427";"melipeuco";"50 a 54";232;181;413
"4428";"melipeuco";"55 a 59";199;193;392
"4429";"melipeuco";"60 a 64";173;172;345
"4430";"melipeuco";"65 a 69";182;148;330
"4431";"melipeuco";"70 a 74";140;126;266
"4432";"melipeuco";"75 a 79";105;108;213
"4433";"melipeuco";"80 a 84";60;72;132
"4434";"melipeuco";"85 a 89";44;43;87
"4435";"melipeuco";"90 a 94";9;28;37
"4436";"melipeuco";"95 a 99";4;5;9
"4437";"melipeuco";"100 o más";0;1;1
"4438";"nueva imperial";"20 a 24";1148;1243;2391
"4439";"nueva imperial";"25 a 29";1079;1170;2249
"4440";"nueva imperial";"30 a 34";909;1056;1965
"4441";"nueva imperial";"35 a 39";871;1022;1893
"4442";"nueva imperial";"40 a 44";1047;1053;2100
"4443";"nueva imperial";"45 a 49";1042;1023;2065
"4444";"nueva imperial";"50 a 54";1068;1096;2164
"4445";"nueva imperial";"55 a 59";962;949;1911
"4446";"nueva imperial";"60 a 64";810;869;1679
"4447";"nueva imperial";"65 a 69";684;674;1358
"4448";"nueva imperial";"70 a 74";555;617;1172
"4449";"nueva imperial";"75 a 79";416;457;873
"4450";"nueva imperial";"80 a 84";268;364;632
"4451";"nueva imperial";"85 a 89";137;226;363
"4452";"nueva imperial";"90 a 94";43;103;146
"4453";"nueva imperial";"95 a 99";21;27;48
"4454";"nueva imperial";"100 o más";4;6;10
"4455";"padre las casas";"20 a 24";3177;3135;6312
"4456";"padre las casas";"25 a 29";2858;3040;5898
"4457";"padre las casas";"30 a 34";2558;2792;5350
"4458";"padre las casas";"35 a 39";2404;2561;4965
"4459";"padre las casas";"40 a 44";2544;2719;5263
"4460";"padre las casas";"45 a 49";2457;2777;5234
"4461";"padre las casas";"50 a 54";2459;2549;5008
"4462";"padre las casas";"55 a 59";1916;2083;3999
"4463";"padre las casas";"60 a 64";1482;1784;3266
"4464";"padre las casas";"65 a 69";1129;1296;2425
"4465";"padre las casas";"70 a 74";878;1037;1915
"4466";"padre las casas";"75 a 79";603;791;1394
"4467";"padre las casas";"80 a 84";372;527;899
"4468";"padre las casas";"85 a 89";166;327;493
"4469";"padre las casas";"90 a 94";68;137;205
"4470";"padre las casas";"95 a 99";15;30;45
"4471";"padre las casas";"100 o más";6;8;14
"4472";"perquenco";"20 a 24";221;256;477
"4473";"perquenco";"25 a 29";233;242;475
"4474";"perquenco";"30 a 34";188;199;387
"4475";"perquenco";"35 a 39";197;197;394
"4476";"perquenco";"40 a 44";246;257;503
"4477";"perquenco";"45 a 49";226;257;483
"4478";"perquenco";"50 a 54";269;236;505
"4479";"perquenco";"55 a 59";212;198;410
"4480";"perquenco";"60 a 64";178;166;344
"4481";"perquenco";"65 a 69";141;137;278
"4482";"perquenco";"70 a 74";117;112;229
"4483";"perquenco";"75 a 79";87;99;186
"4484";"perquenco";"80 a 84";60;70;130
"4485";"perquenco";"85 a 89";28;42;70
"4486";"perquenco";"90 a 94";6;13;19
"4487";"perquenco";"95 a 99";0;4;4
"4488";"perquenco";"100 o más";0;1;1
"4489";"pitrufquén";"20 a 24";781;878;1659
"4490";"pitrufquén";"25 a 29";800;843;1643
"4491";"pitrufquén";"30 a 34";717;782;1499
"4492";"pitrufquén";"35 a 39";724;775;1499
"4493";"pitrufquén";"40 a 44";835;925;1760
"4494";"pitrufquén";"45 a 49";831;912;1743
"4495";"pitrufquén";"50 a 54";883;916;1799
"4496";"pitrufquén";"55 a 59";779;760;1539
"4497";"pitrufquén";"60 a 64";677;642;1319
"4498";"pitrufquén";"65 a 69";514;595;1109
"4499";"pitrufquén";"70 a 74";438;479;917
"4500";"pitrufquén";"75 a 79";288;409;697
"4501";"pitrufquén";"80 a 84";199;296;495
"4502";"pitrufquén";"85 a 89";117;194;311
"4503";"pitrufquén";"90 a 94";44;93;137
"4504";"pitrufquén";"95 a 99";14;23;37
"4505";"pitrufquén";"100 o más";7;8;15
"4506";"pucón";"20 a 24";976;983;1959
"4507";"pucón";"25 a 29";1241;1243;2484
"4508";"pucón";"30 a 34";1014;1164;2178
"4509";"pucón";"35 a 39";1073;1073;2146
"4510";"pucón";"40 a 44";1043;1043;2086
"4511";"pucón";"45 a 49";934;966;1900
"4512";"pucón";"50 a 54";953;917;1870
"4513";"pucón";"55 a 59";828;789;1617
"4514";"pucón";"60 a 64";583;657;1240
"4515";"pucón";"65 a 69";489;537;1026
"4516";"pucón";"70 a 74";404;410;814
"4517";"pucón";"75 a 79";267;313;580
"4518";"pucón";"80 a 84";152;200;352
"4519";"pucón";"85 a 89";88;131;219
"4520";"pucón";"90 a 94";27;58;85
"4521";"pucón";"95 a 99";6;17;23
"4522";"pucón";"100 o más";4;3;7
"4523";"saavedra";"20 a 24";343;363;706
"4524";"saavedra";"25 a 29";357;398;755
"4525";"saavedra";"30 a 34";352;411;763
"4526";"saavedra";"35 a 39";368;359;727
"4527";"saavedra";"40 a 44";343;394;737
"4528";"saavedra";"45 a 49";430;425;855
"4529";"saavedra";"50 a 54";427;422;849
"4530";"saavedra";"55 a 59";456;395;851
"4531";"saavedra";"60 a 64";378;365;743
"4532";"saavedra";"65 a 69";293;306;599
"4533";"saavedra";"70 a 74";242;258;500
"4534";"saavedra";"75 a 79";196;196;392
"4535";"saavedra";"80 a 84";136;146;282
"4536";"saavedra";"85 a 89";70;83;153
"4537";"saavedra";"90 a 94";32;50;82
"4538";"saavedra";"95 a 99";8;19;27
"4539";"saavedra";"100 o más";2;4;6
"4540";"teodoro schmidt";"20 a 24";388;423;811
"4541";"teodoro schmidt";"25 a 29";464;471;935
"4542";"teodoro schmidt";"30 a 34";424;441;865
"4543";"teodoro schmidt";"35 a 39";448;438;886
"4544";"teodoro schmidt";"40 a 44";536;482;1018
"4545";"teodoro schmidt";"45 a 49";568;536;1104
"4546";"teodoro schmidt";"50 a 54";578;540;1118
"4547";"teodoro schmidt";"55 a 59";516;511;1027
"4548";"teodoro schmidt";"60 a 64";485;404;889
"4549";"teodoro schmidt";"65 a 69";388;369;757
"4550";"teodoro schmidt";"70 a 74";340;309;649
"4551";"teodoro schmidt";"75 a 79";228;246;474
"4552";"teodoro schmidt";"80 a 84";154;183;337
"4553";"teodoro schmidt";"85 a 89";72;130;202
"4554";"teodoro schmidt";"90 a 94";20;50;70
"4555";"teodoro schmidt";"95 a 99";9;11;20
"4556";"teodoro schmidt";"100 o más";1;3;4
"4557";"toltén";"20 a 24";232;232;464
"4558";"toltén";"25 a 29";296;320;616
"4559";"toltén";"30 a 34";254;312;566
"4560";"toltén";"35 a 39";262;270;532
"4561";"toltén";"40 a 44";346;341;687
"4562";"toltén";"45 a 49";355;338;693
"4563";"toltén";"50 a 54";391;391;782
"4564";"toltén";"55 a 59";371;303;674
"4565";"toltén";"60 a 64";280;277;557
"4566";"toltén";"65 a 69";229;207;436
"4567";"toltén";"70 a 74";187;203;390
"4568";"toltén";"75 a 79";142;146;288
"4569";"toltén";"80 a 84";104;123;227
"4570";"toltén";"85 a 89";59;66;125
"4571";"toltén";"90 a 94";18;32;50
"4572";"toltén";"95 a 99";0;8;8
"4573";"toltén";"100 o más";4;5;9
"4574";"vilcún";"20 a 24";995;1062;2057
"4575";"vilcún";"25 a 29";960;1039;1999
"4576";"vilcún";"30 a 34";841;896;1737
"4577";"vilcún";"35 a 39";895;1023;1918
"4578";"vilcún";"40 a 44";987;1031;2018
"4579";"vilcún";"45 a 49";1005;975;1980
"4580";"vilcún";"50 a 54";916;909;1825
"4581";"vilcún";"55 a 59";794;764;1558
"4582";"vilcún";"60 a 64";624;652;1276
"4583";"vilcún";"65 a 69";504;515;1019
"4584";"vilcún";"70 a 74";413;433;846
"4585";"vilcún";"75 a 79";273;348;621
"4586";"vilcún";"80 a 84";185;217;402
"4587";"vilcún";"85 a 89";101;128;229
"4588";"vilcún";"90 a 94";27;56;83
"4589";"vilcún";"95 a 99";3;12;15
"4590";"vilcún";"100 o más";3;7;10
"4591";"villarrica";"20 a 24";1866;1891;3757
"4592";"villarrica";"25 a 29";2014;2088;4102
"4593";"villarrica";"30 a 34";1775;2007;3782
"4594";"villarrica";"35 a 39";1725;1888;3613
"4595";"villarrica";"40 a 44";1829;1952;3781
"4596";"villarrica";"45 a 49";2001;2064;4065
"4597";"villarrica";"50 a 54";1928;1959;3887
"4598";"villarrica";"55 a 59";1551;1692;3243
"4599";"villarrica";"60 a 64";1360;1342;2702
"4600";"villarrica";"65 a 69";1025;1151;2176
"4601";"villarrica";"70 a 74";820;938;1758
"4602";"villarrica";"75 a 79";544;669;1213
"4603";"villarrica";"80 a 84";342;468;810
"4604";"villarrica";"85 a 89";189;298;487
"4605";"villarrica";"90 a 94";86;135;221
"4606";"villarrica";"95 a 99";15;36;51
"4607";"villarrica";"100 o más";2;11;13
"4608";"cholchol";"20 a 24";375;394;769
"4609";"cholchol";"25 a 29";328;407;735
"4610";"cholchol";"30 a 34";339;371;710
"4611";"cholchol";"35 a 39";323;382;705
"4612";"cholchol";"40 a 44";369;338;707
"4613";"cholchol";"45 a 49";360;366;726
"4614";"cholchol";"50 a 54";359;346;705
"4615";"cholchol";"55 a 59";355;334;689
"4616";"cholchol";"60 a 64";286;281;567
"4617";"cholchol";"65 a 69";238;215;453
"4618";"cholchol";"70 a 74";206;212;418
"4619";"cholchol";"75 a 79";160;148;308
"4620";"cholchol";"80 a 84";110;136;246
"4621";"cholchol";"85 a 89";60;88;148
"4622";"cholchol";"90 a 94";19;41;60
"4623";"cholchol";"95 a 99";6;5;11
"4624";"cholchol";"100 o más";1;1;2
"4625";"angol";"20 a 24";1633;1759;3392
"4626";"angol";"25 a 29";2021;2063;4084
"4627";"angol";"30 a 34";1758;1975;3733
"4628";"angol";"35 a 39";1641;1863;3504
"4629";"angol";"40 a 44";1707;1834;3541
"4630";"angol";"45 a 49";1649;1899;3548
"4631";"angol";"50 a 54";1699;1915;3614
"4632";"angol";"55 a 59";1563;1724;3287
"4633";"angol";"60 a 64";1317;1424;2741
"4634";"angol";"65 a 69";960;1129;2089
"4635";"angol";"70 a 74";779;918;1697
"4636";"angol";"75 a 79";600;726;1326
"4637";"angol";"80 a 84";355;536;891
"4638";"angol";"85 a 89";191;356;547
"4639";"angol";"90 a 94";63;122;185
"4640";"angol";"95 a 99";18;43;61
"4641";"angol";"100 o más";4;11;15
"4642";"collipulli";"20 a 24";744;830;1574
"4643";"collipulli";"25 a 29";870;971;1841
"4644";"collipulli";"30 a 34";737;895;1632
"4645";"collipulli";"35 a 39";734;812;1546
"4646";"collipulli";"40 a 44";770;821;1591
"4647";"collipulli";"45 a 49";789;832;1621
"4648";"collipulli";"50 a 54";816;851;1667
"4649";"collipulli";"55 a 59";789;729;1518
"4650";"collipulli";"60 a 64";624;643;1267
"4651";"collipulli";"65 a 69";487;514;1001
"4652";"collipulli";"70 a 74";362;384;746
"4653";"collipulli";"75 a 79";279;293;572
"4654";"collipulli";"80 a 84";147;212;359
"4655";"collipulli";"85 a 89";82;122;204
"4656";"collipulli";"90 a 94";43;40;83
"4657";"collipulli";"95 a 99";14;15;29
"4658";"collipulli";"100 o más";1;6;7
"4659";"curacautín";"20 a 24";524;529;1053
"4660";"curacautín";"25 a 29";494;597;1091
"4661";"curacautín";"30 a 34";448;530;978
"4662";"curacautín";"35 a 39";496;583;1079
"4663";"curacautín";"40 a 44";508;583;1091
"4664";"curacautín";"45 a 49";568;627;1195
"4665";"curacautín";"50 a 54";644;663;1307
"4666";"curacautín";"55 a 59";522;601;1123
"4667";"curacautín";"60 a 64";500;538;1038
"4668";"curacautín";"65 a 69";406;489;895
"4669";"curacautín";"70 a 74";334;383;717
"4670";"curacautín";"75 a 79";245;271;516
"4671";"curacautín";"80 a 84";157;195;352
"4672";"curacautín";"85 a 89";99;111;210
"4673";"curacautín";"90 a 94";32;57;89
"4674";"curacautín";"95 a 99";9;13;22
"4675";"curacautín";"100 o más";1;4;5
"4676";"ercilla";"20 a 24";267;278;545
"4677";"ercilla";"25 a 29";235;268;503
"4678";"ercilla";"30 a 34";235;246;481
"4679";"ercilla";"35 a 39";218;232;450
"4680";"ercilla";"40 a 44";237;283;520
"4681";"ercilla";"45 a 49";259;247;506
"4682";"ercilla";"50 a 54";233;250;483
"4683";"ercilla";"55 a 59";210;219;429
"4684";"ercilla";"60 a 64";205;199;404
"4685";"ercilla";"65 a 69";154;183;337
"4686";"ercilla";"70 a 74";144;125;269
"4687";"ercilla";"75 a 79";101;101;202
"4688";"ercilla";"80 a 84";64;79;143
"4689";"ercilla";"85 a 89";34;40;74
"4690";"ercilla";"90 a 94";14;28;42
"4691";"ercilla";"95 a 99";2;3;5
"4692";"ercilla";"100 o más";0;0;0
"4693";"lonquimay";"20 a 24";376;301;677
"4694";"lonquimay";"25 a 29";364;321;685
"4695";"lonquimay";"30 a 34";323;316;639
"4696";"lonquimay";"35 a 39";361;330;691
"4697";"lonquimay";"40 a 44";386;347;733
"4698";"lonquimay";"45 a 49";366;311;677
"4699";"lonquimay";"50 a 54";340;339;679
"4700";"lonquimay";"55 a 59";325;280;605
"4701";"lonquimay";"60 a 64";277;250;527
"4702";"lonquimay";"65 a 69";211;183;394
"4703";"lonquimay";"70 a 74";165;174;339
"4704";"lonquimay";"75 a 79";119;112;231
"4705";"lonquimay";"80 a 84";81;101;182
"4706";"lonquimay";"85 a 89";36;50;86
"4707";"lonquimay";"90 a 94";17;21;38
"4708";"lonquimay";"95 a 99";3;6;9
"4709";"lonquimay";"100 o más";0;2;2
"4710";"los sauces";"20 a 24";211;230;441
"4711";"los sauces";"25 a 29";201;275;476
"4712";"los sauces";"30 a 34";218;228;446
"4713";"los sauces";"35 a 39";217;229;446
"4714";"los sauces";"40 a 44";216;239;455
"4715";"los sauces";"45 a 49";254;238;492
"4716";"los sauces";"50 a 54";283;257;540
"4717";"los sauces";"55 a 59";254;222;476
"4718";"los sauces";"60 a 64";227;206;433
"4719";"los sauces";"65 a 69";151;163;314
"4720";"los sauces";"70 a 74";151;141;292
"4721";"los sauces";"75 a 79";116;112;228
"4722";"los sauces";"80 a 84";62;84;146
"4723";"los sauces";"85 a 89";38;53;91
"4724";"los sauces";"90 a 94";13;20;33
"4725";"los sauces";"95 a 99";4;4;8
"4726";"los sauces";"100 o más";0;2;2
"4727";"lumaco";"20 a 24";303;281;584
"4728";"lumaco";"25 a 29";281;309;590
"4729";"lumaco";"30 a 34";253;302;555
"4730";"lumaco";"35 a 39";295;312;607
"4731";"lumaco";"40 a 44";325;303;628
"4732";"lumaco";"45 a 49";370;327;697
"4733";"lumaco";"50 a 54";399;358;757
"4734";"lumaco";"55 a 59";333;253;586
"4735";"lumaco";"60 a 64";255;228;483
"4736";"lumaco";"65 a 69";244;192;436
"4737";"lumaco";"70 a 74";179;184;363
"4738";"lumaco";"75 a 79";137;129;266
"4739";"lumaco";"80 a 84";110;84;194
"4740";"lumaco";"85 a 89";47;44;91
"4741";"lumaco";"90 a 94";10;28;38
"4742";"lumaco";"95 a 99";4;11;15
"4743";"lumaco";"100 o más";1;1;2
"4744";"purén";"20 a 24";324;361;685
"4745";"purén";"25 a 29";345;431;776
"4746";"purén";"30 a 34";321;389;710
"4747";"purén";"35 a 39";342;372;714
"4748";"purén";"40 a 44";346;380;726
"4749";"purén";"45 a 49";435;434;869
"4750";"purén";"50 a 54";400;441;841
"4751";"purén";"55 a 59";368;396;764
"4752";"purén";"60 a 64";346;352;698
"4753";"purén";"65 a 69";250;261;511
"4754";"purén";"70 a 74";195;222;417
"4755";"purén";"75 a 79";154;181;335
"4756";"purén";"80 a 84";125;125;250
"4757";"purén";"85 a 89";53;79;132
"4758";"purén";"90 a 94";27;41;68
"4759";"purén";"95 a 99";11;14;25
"4760";"purén";"100 o más";0;4;4
"4761";"renaico";"20 a 24";314;389;703
"4762";"renaico";"25 a 29";360;431;791
"4763";"renaico";"30 a 34";334;367;701
"4764";"renaico";"35 a 39";287;336;623
"4765";"renaico";"40 a 44";319;360;679
"4766";"renaico";"45 a 49";352;359;711
"4767";"renaico";"50 a 54";366;353;719
"4768";"renaico";"55 a 59";310;328;638
"4769";"renaico";"60 a 64";280;271;551
"4770";"renaico";"65 a 69";212;205;417
"4771";"renaico";"70 a 74";146;194;340
"4772";"renaico";"75 a 79";113;126;239
"4773";"renaico";"80 a 84";70;68;138
"4774";"renaico";"85 a 89";34;51;85
"4775";"renaico";"90 a 94";6;16;22
"4776";"renaico";"95 a 99";5;9;14
"4777";"renaico";"100 o más";1;0;1
"4778";"traiguén";"20 a 24";506;585;1091
"4779";"traiguén";"25 a 29";552;609;1161
"4780";"traiguén";"30 a 34";520;621;1141
"4781";"traiguén";"35 a 39";499;595;1094
"4782";"traiguén";"40 a 44";507;578;1085
"4783";"traiguén";"45 a 49";563;646;1209
"4784";"traiguén";"50 a 54";662;740;1402
"4785";"traiguén";"55 a 59";618;657;1275
"4786";"traiguén";"60 a 64";506;563;1069
"4787";"traiguén";"65 a 69";412;444;856
"4788";"traiguén";"70 a 74";314;398;712
"4789";"traiguén";"75 a 79";261;302;563
"4790";"traiguén";"80 a 84";172;241;413
"4791";"traiguén";"85 a 89";93;150;243
"4792";"traiguén";"90 a 94";33;69;102
"4793";"traiguén";"95 a 99";7;17;24
"4794";"traiguén";"100 o más";3;5;8
"4795";"victoria";"20 a 24";1155;1283;2438
"4796";"victoria";"25 a 29";1106;1302;2408
"4797";"victoria";"30 a 34";1065;1151;2216
"4798";"victoria";"35 a 39";966;1111;2077
"4799";"victoria";"40 a 44";973;1162;2135
"4800";"victoria";"45 a 49";1118;1182;2300
"4801";"victoria";"50 a 54";1219;1337;2556
"4802";"victoria";"55 a 59";1039;1076;2115
"4803";"victoria";"60 a 64";893;1012;1905
"4804";"victoria";"65 a 69";710;749;1459
"4805";"victoria";"70 a 74";556;676;1232
"4806";"victoria";"75 a 79";360;502;862
"4807";"victoria";"80 a 84";234;374;608
"4808";"victoria";"85 a 89";136;249;385
"4809";"victoria";"90 a 94";60;102;162
"4810";"victoria";"95 a 99";12;29;41
"4811";"victoria";"100 o más";4;9;13
"4812";"valdivia";"20 a 24";8330;7976;16306
"4813";"valdivia";"25 a 29";7210;7025;14235
"4814";"valdivia";"30 a 34";5827;5982;11809
"4815";"valdivia";"35 a 39";5204;5555;10759
"4816";"valdivia";"40 a 44";5046;5528;10574
"4817";"valdivia";"45 a 49";5053;5416;10469
"4818";"valdivia";"50 a 54";5372;5999;11371
"4819";"valdivia";"55 a 59";4555;5187;9742
"4820";"valdivia";"60 a 64";3771;4245;8016
"4821";"valdivia";"65 a 69";2781;3437;6218
"4822";"valdivia";"70 a 74";2027;2703;4730
"4823";"valdivia";"75 a 79";1357;2033;3390
"4824";"valdivia";"80 a 84";828;1427;2255
"4825";"valdivia";"85 a 89";471;949;1420
"4826";"valdivia";"90 a 94";198;390;588
"4827";"valdivia";"95 a 99";37;129;166
"4828";"valdivia";"100 o más";13;33;46
"4829";"corral";"20 a 24";171;176;347
"4830";"corral";"25 a 29";172;202;374
"4831";"corral";"30 a 34";159;140;299
"4832";"corral";"35 a 39";114;143;257
"4833";"corral";"40 a 44";174;169;343
"4834";"corral";"45 a 49";210;220;430
"4835";"corral";"50 a 54";221;204;425
"4836";"corral";"55 a 59";161;196;357
"4837";"corral";"60 a 64";167;144;311
"4838";"corral";"65 a 69";146;111;257
"4839";"corral";"70 a 74";100;102;202
"4840";"corral";"75 a 79";79;90;169
"4841";"corral";"80 a 84";43;58;101
"4842";"corral";"85 a 89";27;44;71
"4843";"corral";"90 a 94";13;10;23
"4844";"corral";"95 a 99";4;1;5
"4845";"corral";"100 o más";0;0;0
"4846";"lanco";"20 a 24";506;550;1056
"4847";"lanco";"25 a 29";557;635;1192
"4848";"lanco";"30 a 34";500;583;1083
"4849";"lanco";"35 a 39";489;538;1027
"4850";"lanco";"40 a 44";504;529;1033
"4851";"lanco";"45 a 49";596;596;1192
"4852";"lanco";"50 a 54";619;599;1218
"4853";"lanco";"55 a 59";515;509;1024
"4854";"lanco";"60 a 64";427;471;898
"4855";"lanco";"65 a 69";347;344;691
"4856";"lanco";"70 a 74";258;284;542
"4857";"lanco";"75 a 79";184;250;434
"4858";"lanco";"80 a 84";133;170;303
"4859";"lanco";"85 a 89";77;103;180
"4860";"lanco";"90 a 94";19;34;53
"4861";"lanco";"95 a 99";7;9;16
"4862";"lanco";"100 o más";1;2;3
"4863";"los lagos";"20 a 24";623;671;1294
"4864";"los lagos";"25 a 29";721;719;1440
"4865";"los lagos";"30 a 34";603;690;1293
"4866";"los lagos";"35 a 39";572;609;1181
"4867";"los lagos";"40 a 44";664;624;1288
"4868";"los lagos";"45 a 49";702;645;1347
"4869";"los lagos";"50 a 54";703;728;1431
"4870";"los lagos";"55 a 59";630;637;1267
"4871";"los lagos";"60 a 64";553;515;1068
"4872";"los lagos";"65 a 69";413;378;791
"4873";"los lagos";"70 a 74";330;352;682
"4874";"los lagos";"75 a 79";233;271;504
"4875";"los lagos";"80 a 84";132;164;296
"4876";"los lagos";"85 a 89";64;95;159
"4877";"los lagos";"90 a 94";25;45;70
"4878";"los lagos";"95 a 99";5;15;20
"4879";"los lagos";"100 o más";1;2;3
"4880";"máfil";"20 a 24";240;241;481
"4881";"máfil";"25 a 29";280;270;550
"4882";"máfil";"30 a 34";223;242;465
"4883";"máfil";"35 a 39";221;204;425
"4884";"máfil";"40 a 44";185;206;391
"4885";"máfil";"45 a 49";226;235;461
"4886";"máfil";"50 a 54";281;265;546
"4887";"máfil";"55 a 59";218;207;425
"4888";"máfil";"60 a 64";192;188;380
"4889";"máfil";"65 a 69";153;147;300
"4890";"máfil";"70 a 74";120;147;267
"4891";"máfil";"75 a 79";87;101;188
"4892";"máfil";"80 a 84";53;68;121
"4893";"máfil";"85 a 89";29;34;63
"4894";"máfil";"90 a 94";11;22;33
"4895";"máfil";"95 a 99";5;5;10
"4896";"máfil";"100 o más";6;7;13
"4897";"mariquina";"20 a 24";758;763;1521
"4898";"mariquina";"25 a 29";732;834;1566
"4899";"mariquina";"30 a 34";673;691;1364
"4900";"mariquina";"35 a 39";642;702;1344
"4901";"mariquina";"40 a 44";685;678;1363
"4902";"mariquina";"45 a 49";698;748;1446
"4903";"mariquina";"50 a 54";752;668;1420
"4904";"mariquina";"55 a 59";607;617;1224
"4905";"mariquina";"60 a 64";494;467;961
"4906";"mariquina";"65 a 69";405;384;789
"4907";"mariquina";"70 a 74";349;349;698
"4908";"mariquina";"75 a 79";227;269;496
"4909";"mariquina";"80 a 84";139;161;300
"4910";"mariquina";"85 a 89";93;106;199
"4911";"mariquina";"90 a 94";28;52;80
"4912";"mariquina";"95 a 99";5;9;14
"4913";"mariquina";"100 o más";2;1;3
"4914";"paillaco";"20 a 24";648;695;1343
"4915";"paillaco";"25 a 29";691;687;1378
"4916";"paillaco";"30 a 34";608;633;1241
"4917";"paillaco";"35 a 39";633;622;1255
"4918";"paillaco";"40 a 44";663;643;1306
"4919";"paillaco";"45 a 49";686;683;1369
"4920";"paillaco";"50 a 54";758;682;1440
"4921";"paillaco";"55 a 59";656;653;1309
"4922";"paillaco";"60 a 64";535;582;1117
"4923";"paillaco";"65 a 69";404;427;831
"4924";"paillaco";"70 a 74";342;370;712
"4925";"paillaco";"75 a 79";227;275;502
"4926";"paillaco";"80 a 84";147;171;318
"4927";"paillaco";"85 a 89";94;132;226
"4928";"paillaco";"90 a 94";29;60;89
"4929";"paillaco";"95 a 99";5;5;10
"4930";"paillaco";"100 o más";3;5;8
"4931";"panguipulli";"20 a 24";1018;1134;2152
"4932";"panguipulli";"25 a 29";1162;1234;2396
"4933";"panguipulli";"30 a 34";1108;1215;2323
"4934";"panguipulli";"35 a 39";1051;1116;2167
"4935";"panguipulli";"40 a 44";1191;1176;2367
"4936";"panguipulli";"45 a 49";1257;1172;2429
"4937";"panguipulli";"50 a 54";1295;1220;2515
"4938";"panguipulli";"55 a 59";1059;1029;2088
"4939";"panguipulli";"60 a 64";869;873;1742
"4940";"panguipulli";"65 a 69";739;719;1458
"4941";"panguipulli";"70 a 74";549;558;1107
"4942";"panguipulli";"75 a 79";374;456;830
"4943";"panguipulli";"80 a 84";227;276;503
"4944";"panguipulli";"85 a 89";165;185;350
"4945";"panguipulli";"90 a 94";47;77;124
"4946";"panguipulli";"95 a 99";12;29;41
"4947";"panguipulli";"100 o más";5;8;13
"4948";"la unión";"20 a 24";1200;1285;2485
"4949";"la unión";"25 a 29";1232;1379;2611
"4950";"la unión";"30 a 34";1102;1211;2313
"4951";"la unión";"35 a 39";1077;1190;2267
"4952";"la unión";"40 a 44";1174;1263;2437
"4953";"la unión";"45 a 49";1260;1310;2570
"4954";"la unión";"50 a 54";1410;1386;2796
"4955";"la unión";"55 a 59";1264;1261;2525
"4956";"la unión";"60 a 64";967;1052;2019
"4957";"la unión";"65 a 69";837;911;1748
"4958";"la unión";"70 a 74";625;733;1358
"4959";"la unión";"75 a 79";443;514;957
"4960";"la unión";"80 a 84";313;421;734
"4961";"la unión";"85 a 89";135;240;375
"4962";"la unión";"90 a 94";54;103;157
"4963";"la unión";"95 a 99";8;22;30
"4964";"la unión";"100 o más";6;12;18
"4965";"futrono";"20 a 24";417;488;905
"4966";"futrono";"25 a 29";530;546;1076
"4967";"futrono";"30 a 34";449;454;903
"4968";"futrono";"35 a 39";414;469;883
"4969";"futrono";"40 a 44";521;495;1016
"4970";"futrono";"45 a 49";482;540;1022
"4971";"futrono";"50 a 54";551;517;1068
"4972";"futrono";"55 a 59";503;433;936
"4973";"futrono";"60 a 64";357;389;746
"4974";"futrono";"65 a 69";280;314;594
"4975";"futrono";"70 a 74";234;229;463
"4976";"futrono";"75 a 79";173;182;355
"4977";"futrono";"80 a 84";115;107;222
"4978";"futrono";"85 a 89";57;64;121
"4979";"futrono";"90 a 94";21;25;46
"4980";"futrono";"95 a 99";1;3;4
"4981";"futrono";"100 o más";2;0;2
"4982";"lago ranco";"20 a 24";268;271;539
"4983";"lago ranco";"25 a 29";317;324;641
"4984";"lago ranco";"30 a 34";278;291;569
"4985";"lago ranco";"35 a 39";300;274;574
"4986";"lago ranco";"40 a 44";334;363;697
"4987";"lago ranco";"45 a 49";398;355;753
"4988";"lago ranco";"50 a 54";408;360;768
"4989";"lago ranco";"55 a 59";361;302;663
"4990";"lago ranco";"60 a 64";316;278;594
"4991";"lago ranco";"65 a 69";237;227;464
"4992";"lago ranco";"70 a 74";179;187;366
"4993";"lago ranco";"75 a 79";134;151;285
"4994";"lago ranco";"80 a 84";98;98;196
"4995";"lago ranco";"85 a 89";41;67;108
"4996";"lago ranco";"90 a 94";15;23;38
"4997";"lago ranco";"95 a 99";5;6;11
"4998";"lago ranco";"100 o más";2;3;5
"4999";"río bueno";"20 a 24";949;998;1947
"5000";"río bueno";"25 a 29";1047;1101;2148
"5001";"río bueno";"30 a 34";899;959;1858
"5002";"río bueno";"35 a 39";887;928;1815
"5003";"río bueno";"40 a 44";1046;1077;2123
"5004";"río bueno";"45 a 49";1147;1085;2232
"5005";"río bueno";"50 a 54";1240;1156;2396
"5006";"río bueno";"55 a 59";1110;1069;2179
"5007";"río bueno";"60 a 64";910;912;1822
"5008";"río bueno";"65 a 69";705;763;1468
"5009";"río bueno";"70 a 74";581;622;1203
"5010";"río bueno";"75 a 79";409;514;923
"5011";"río bueno";"80 a 84";244;325;569
"5012";"río bueno";"85 a 89";118;218;336
"5013";"río bueno";"90 a 94";57;82;139
"5014";"río bueno";"95 a 99";8;33;41
"5015";"río bueno";"100 o más";3;5;8
"5016";"puerto montt";"20 a 24";10188;10313;20501
"5017";"puerto montt";"25 a 29";10710;10711;21421
"5018";"puerto montt";"30 a 34";9277;9663;18940
"5019";"puerto montt";"35 a 39";9068;9121;18189
"5020";"puerto montt";"40 a 44";8937;9129;18066
"5021";"puerto montt";"45 a 49";8364;8766;17130
"5022";"puerto montt";"50 a 54";7924;8307;16231
"5023";"puerto montt";"55 a 59";6073;6491;12564
"5024";"puerto montt";"60 a 64";4562;5022;9584
"5025";"puerto montt";"65 a 69";3418;3783;7201
"5026";"puerto montt";"70 a 74";2463;2884;5347
"5027";"puerto montt";"75 a 79";1617;2274;3891
"5028";"puerto montt";"80 a 84";921;1389;2310
"5029";"puerto montt";"85 a 89";493;910;1403
"5030";"puerto montt";"90 a 94";201;390;591
"5031";"puerto montt";"95 a 99";51;98;149
"5032";"puerto montt";"100 o más";23;37;60
"5033";"calbuco";"20 a 24";1165;1207;2372
"5034";"calbuco";"25 a 29";1275;1288;2563
"5035";"calbuco";"30 a 34";1112;1098;2210
"5036";"calbuco";"35 a 39";1037;1035;2072
"5037";"calbuco";"40 a 44";1165;1174;2339
"5038";"calbuco";"45 a 49";1392;1230;2622
"5039";"calbuco";"50 a 54";1282;1166;2448
"5040";"calbuco";"55 a 59";985;962;1947
"5041";"calbuco";"60 a 64";798;739;1537
"5042";"calbuco";"65 a 69";633;687;1320
"5043";"calbuco";"70 a 74";533;583;1116
"5044";"calbuco";"75 a 79";383;439;822
"5045";"calbuco";"80 a 84";232;275;507
"5046";"calbuco";"85 a 89";170;209;379
"5047";"calbuco";"90 a 94";50;104;154
"5048";"calbuco";"95 a 99";12;29;41
"5049";"calbuco";"100 o más";2;6;8
"5050";"cochamó";"20 a 24";129;81;210
"5051";"cochamó";"25 a 29";155;130;285
"5052";"cochamó";"30 a 34";140;117;257
"5053";"cochamó";"35 a 39";152;121;273
"5054";"cochamó";"40 a 44";182;110;292
"5055";"cochamó";"45 a 49";170;145;315
"5056";"cochamó";"50 a 54";183;166;349
"5057";"cochamó";"55 a 59";176;120;296
"5058";"cochamó";"60 a 64";145;115;260
"5059";"cochamó";"65 a 69";115;82;197
"5060";"cochamó";"70 a 74";84;75;159
"5061";"cochamó";"75 a 79";63;62;125
"5062";"cochamó";"80 a 84";41;48;89
"5063";"cochamó";"85 a 89";24;27;51
"5064";"cochamó";"90 a 94";11;10;21
"5065";"cochamó";"95 a 99";1;3;4
"5066";"cochamó";"100 o más";0;1;1
"5067";"fresia";"20 a 24";398;395;793
"5068";"fresia";"25 a 29";362;416;778
"5069";"fresia";"30 a 34";325;354;679
"5070";"fresia";"35 a 39";345;360;705
"5071";"fresia";"40 a 44";466;398;864
"5072";"fresia";"45 a 49";439;479;918
"5073";"fresia";"50 a 54";530;446;976
"5074";"fresia";"55 a 59";433;397;830
"5075";"fresia";"60 a 64";393;351;744
"5076";"fresia";"65 a 69";299;289;588
"5077";"fresia";"70 a 74";225;219;444
"5078";"fresia";"75 a 79";177;168;345
"5079";"fresia";"80 a 84";103;142;245
"5080";"fresia";"85 a 89";61;82;143
"5081";"fresia";"90 a 94";13;33;46
"5082";"fresia";"95 a 99";10;9;19
"5083";"fresia";"100 o más";0;2;2
"5084";"frutillar";"20 a 24";612;631;1243
"5085";"frutillar";"25 a 29";699;721;1420
"5086";"frutillar";"30 a 34";602;638;1240
"5087";"frutillar";"35 a 39";601;616;1217
"5088";"frutillar";"40 a 44";654;662;1316
"5089";"frutillar";"45 a 49";570;660;1230
"5090";"frutillar";"50 a 54";700;704;1404
"5091";"frutillar";"55 a 59";605;589;1194
"5092";"frutillar";"60 a 64";471;459;930
"5093";"frutillar";"65 a 69";352;396;748
"5094";"frutillar";"70 a 74";257;282;539
"5095";"frutillar";"75 a 79";202;220;422
"5096";"frutillar";"80 a 84";108;143;251
"5097";"frutillar";"85 a 89";64;80;144
"5098";"frutillar";"90 a 94";31;40;71
"5099";"frutillar";"95 a 99";5;7;12
"5100";"frutillar";"100 o más";2;2;4
"5101";"los muermos";"20 a 24";532;514;1046
"5102";"los muermos";"25 a 29";581;582;1163
"5103";"los muermos";"30 a 34";472;527;999
"5104";"los muermos";"35 a 39";498;494;992
"5105";"los muermos";"40 a 44";632;576;1208
"5106";"los muermos";"45 a 49";688;595;1283
"5107";"los muermos";"50 a 54";683;659;1342
"5108";"los muermos";"55 a 59";564;517;1081
"5109";"los muermos";"60 a 64";488;424;912
"5110";"los muermos";"65 a 69";435;379;814
"5111";"los muermos";"70 a 74";333;299;632
"5112";"los muermos";"75 a 79";251;241;492
"5113";"los muermos";"80 a 84";150;168;318
"5114";"los muermos";"85 a 89";80;90;170
"5115";"los muermos";"90 a 94";30;48;78
"5116";"los muermos";"95 a 99";11;9;20
"5117";"los muermos";"100 o más";1;3;4
"5118";"llanquihue";"20 a 24";648;646;1294
"5119";"llanquihue";"25 a 29";624;650;1274
"5120";"llanquihue";"30 a 34";543;572;1115
"5121";"llanquihue";"35 a 39";543;558;1101
"5122";"llanquihue";"40 a 44";604;645;1249
"5123";"llanquihue";"45 a 49";623;648;1271
"5124";"llanquihue";"50 a 54";673;682;1355
"5125";"llanquihue";"55 a 59";552;528;1080
"5126";"llanquihue";"60 a 64";446;471;917
"5127";"llanquihue";"65 a 69";344;331;675
"5128";"llanquihue";"70 a 74";266;302;568
"5129";"llanquihue";"75 a 79";179;229;408
"5130";"llanquihue";"80 a 84";91;130;221
"5131";"llanquihue";"85 a 89";38;89;127
"5132";"llanquihue";"90 a 94";16;32;48
"5133";"llanquihue";"95 a 99";7;6;13
"5134";"llanquihue";"100 o más";1;1;2
"5135";"maullín";"20 a 24";383;422;805
"5136";"maullín";"25 a 29";442;489;931
"5137";"maullín";"30 a 34";389;386;775
"5138";"maullín";"35 a 39";354;399;753
"5139";"maullín";"40 a 44";481;483;964
"5140";"maullín";"45 a 49";610;528;1138
"5141";"maullín";"50 a 54";634;579;1213
"5142";"maullín";"55 a 59";530;464;994
"5143";"maullín";"60 a 64";441;427;868
"5144";"maullín";"65 a 69";380;338;718
"5145";"maullín";"70 a 74";329;292;621
"5146";"maullín";"75 a 79";224;238;462
"5147";"maullín";"80 a 84";155;146;301
"5148";"maullín";"85 a 89";62;95;157
"5149";"maullín";"90 a 94";21;42;63
"5150";"maullín";"95 a 99";5;10;15
"5151";"maullín";"100 o más";1;1;2
"5152";"puerto varas";"20 a 24";1283;1298;2581
"5153";"puerto varas";"25 a 29";1672;1801;3473
"5154";"puerto varas";"30 a 34";1617;1837;3454
"5155";"puerto varas";"35 a 39";1757;1830;3587
"5156";"puerto varas";"40 a 44";1710;1801;3511
"5157";"puerto varas";"45 a 49";1646;1622;3268
"5158";"puerto varas";"50 a 54";1450;1431;2881
"5159";"puerto varas";"55 a 59";1271;1303;2574
"5160";"puerto varas";"60 a 64";923;1024;1947
"5161";"puerto varas";"65 a 69";702;780;1482
"5162";"puerto varas";"70 a 74";534;621;1155
"5163";"puerto varas";"75 a 79";325;444;769
"5164";"puerto varas";"80 a 84";223;299;522
"5165";"puerto varas";"85 a 89";92;180;272
"5166";"puerto varas";"90 a 94";42;71;113
"5167";"puerto varas";"95 a 99";6;34;40
"5168";"puerto varas";"100 o más";3;5;8
"5169";"castro";"20 a 24";1323;1337;2660
"5170";"castro";"25 a 29";1724;1716;3440
"5171";"castro";"30 a 34";1658;1771;3429
"5172";"castro";"35 a 39";1691;1789;3480
"5173";"castro";"40 a 44";1656;1714;3370
"5174";"castro";"45 a 49";1585;1593;3178
"5175";"castro";"50 a 54";1532;1540;3072
"5176";"castro";"55 a 59";1195;1210;2405
"5177";"castro";"60 a 64";881;984;1865
"5178";"castro";"65 a 69";660;822;1482
"5179";"castro";"70 a 74";518;680;1198
"5180";"castro";"75 a 79";372;560;932
"5181";"castro";"80 a 84";225;369;594
"5182";"castro";"85 a 89";99;226;325
"5183";"castro";"90 a 94";71;124;195
"5184";"castro";"95 a 99";11;33;44
"5185";"castro";"100 o más";8;10;18
"5186";"ancud";"20 a 24";1142;1074;2216
"5187";"ancud";"25 a 29";1350;1420;2770
"5188";"ancud";"30 a 34";1189;1381;2570
"5189";"ancud";"35 a 39";1257;1315;2572
"5190";"ancud";"40 a 44";1285;1479;2764
"5191";"ancud";"45 a 49";1363;1465;2828
"5192";"ancud";"50 a 54";1492;1502;2994
"5193";"ancud";"55 a 59";1242;1270;2512
"5194";"ancud";"60 a 64";988;1071;2059
"5195";"ancud";"65 a 69";774;828;1602
"5196";"ancud";"70 a 74";665;710;1375
"5197";"ancud";"75 a 79";461;562;1023
"5198";"ancud";"80 a 84";257;363;620
"5199";"ancud";"85 a 89";162;213;375
"5200";"ancud";"90 a 94";50;101;151
"5201";"ancud";"95 a 99";25;28;53
"5202";"ancud";"100 o más";8;4;12
"5203";"chonchi";"20 a 24";431;438;869
"5204";"chonchi";"25 a 29";522;540;1062
"5205";"chonchi";"30 a 34";555;556;1111
"5206";"chonchi";"35 a 39";535;519;1054
"5207";"chonchi";"40 a 44";613;548;1161
"5208";"chonchi";"45 a 49";577;525;1102
"5209";"chonchi";"50 a 54";526;557;1083
"5210";"chonchi";"55 a 59";434;389;823
"5211";"chonchi";"60 a 64";332;363;695
"5212";"chonchi";"65 a 69";245;281;526
"5213";"chonchi";"70 a 74";197;234;431
"5214";"chonchi";"75 a 79";152;194;346
"5215";"chonchi";"80 a 84";62;142;204
"5216";"chonchi";"85 a 89";43;89;132
"5217";"chonchi";"90 a 94";15;36;51
"5218";"chonchi";"95 a 99";5;6;11
"5219";"chonchi";"100 o más";0;1;1
"5220";"curaco de vélez";"20 a 24";117;98;215
"5221";"curaco de vélez";"25 a 29";100;123;223
"5222";"curaco de vélez";"30 a 34";114;131;245
"5223";"curaco de vélez";"35 a 39";140;138;278
"5224";"curaco de vélez";"40 a 44";149;126;275
"5225";"curaco de vélez";"45 a 49";151;130;281
"5226";"curaco de vélez";"50 a 54";128;123;251
"5227";"curaco de vélez";"55 a 59";95;97;192
"5228";"curaco de vélez";"60 a 64";89;94;183
"5229";"curaco de vélez";"65 a 69";61;93;154
"5230";"curaco de vélez";"70 a 74";67;82;149
"5231";"curaco de vélez";"75 a 79";42;70;112
"5232";"curaco de vélez";"80 a 84";23;49;72
"5233";"curaco de vélez";"85 a 89";14;52;66
"5234";"curaco de vélez";"90 a 94";10;16;26
"5235";"curaco de vélez";"95 a 99";1;6;7
"5236";"curaco de vélez";"100 o más";0;1;1
"5237";"dalcahue";"20 a 24";457;450;907
"5238";"dalcahue";"25 a 29";524;545;1069
"5239";"dalcahue";"30 a 34";474;525;999
"5240";"dalcahue";"35 a 39";469;502;971
"5241";"dalcahue";"40 a 44";504;505;1009
"5242";"dalcahue";"45 a 49";512;515;1027
"5243";"dalcahue";"50 a 54";558;460;1018
"5244";"dalcahue";"55 a 59";376;344;720
"5245";"dalcahue";"60 a 64";275;293;568
"5246";"dalcahue";"65 a 69";229;224;453
"5247";"dalcahue";"70 a 74";167;218;385
"5248";"dalcahue";"75 a 79";138;161;299
"5249";"dalcahue";"80 a 84";96;122;218
"5250";"dalcahue";"85 a 89";43;93;136
"5251";"dalcahue";"90 a 94";20;33;53
"5252";"dalcahue";"95 a 99";8;11;19
"5253";"dalcahue";"100 o más";0;4;4
"5254";"puqueldón";"20 a 24";122;89;211
"5255";"puqueldón";"25 a 29";123;141;264
"5256";"puqueldón";"30 a 34";143;139;282
"5257";"puqueldón";"35 a 39";176;126;302
"5258";"puqueldón";"40 a 44";146;140;286
"5259";"puqueldón";"45 a 49";152;134;286
"5260";"puqueldón";"50 a 54";139;134;273
"5261";"puqueldón";"55 a 59";103;133;236
"5262";"puqueldón";"60 a 64";96;100;196
"5263";"puqueldón";"65 a 69";89;106;195
"5264";"puqueldón";"70 a 74";62;89;151
"5265";"puqueldón";"75 a 79";48;83;131
"5266";"puqueldón";"80 a 84";22;57;79
"5267";"puqueldón";"85 a 89";13;41;54
"5268";"puqueldón";"90 a 94";4;19;23
"5269";"puqueldón";"95 a 99";2;8;10
"5270";"puqueldón";"100 o más";0;4;4
"5271";"queilén";"20 a 24";179;150;329
"5272";"queilén";"25 a 29";206;186;392
"5273";"queilén";"30 a 34";184;159;343
"5274";"queilén";"35 a 39";184;209;393
"5275";"queilén";"40 a 44";233;171;404
"5276";"queilén";"45 a 49";200;190;390
"5277";"queilén";"50 a 54";231;176;407
"5278";"queilén";"55 a 59";179;163;342
"5279";"queilén";"60 a 64";133;132;265
"5280";"queilén";"65 a 69";99;106;205
"5281";"queilén";"70 a 74";86;90;176
"5282";"queilén";"75 a 79";58;77;135
"5283";"queilén";"80 a 84";36;55;91
"5284";"queilén";"85 a 89";25;31;56
"5285";"queilén";"90 a 94";11;21;32
"5286";"queilén";"95 a 99";3;4;7
"5287";"queilén";"100 o más";1;2;3
"5288";"quellón";"20 a 24";934;902;1836
"5289";"quellón";"25 a 29";1246;1259;2505
"5290";"quellón";"30 a 34";1182;1186;2368
"5291";"quellón";"35 a 39";1088;1071;2159
"5292";"quellón";"40 a 44";996;900;1896
"5293";"quellón";"45 a 49";1086;949;2035
"5294";"quellón";"50 a 54";993;844;1837
"5295";"quellón";"55 a 59";767;652;1419
"5296";"quellón";"60 a 64";529;465;994
"5297";"quellón";"65 a 69";340;322;662
"5298";"quellón";"70 a 74";244;283;527
"5299";"quellón";"75 a 79";182;191;373
"5300";"quellón";"80 a 84";88;121;209
"5301";"quellón";"85 a 89";42;82;124
"5302";"quellón";"90 a 94";18;34;52
"5303";"quellón";"95 a 99";0;12;12
"5304";"quellón";"100 o más";0;6;6
"5305";"quemchi";"20 a 24";255;203;458
"5306";"quemchi";"25 a 29";277;279;556
"5307";"quemchi";"30 a 34";263;256;519
"5308";"quemchi";"35 a 39";306;273;579
"5309";"quemchi";"40 a 44";355;306;661
"5310";"quemchi";"45 a 49";362;283;645
"5311";"quemchi";"50 a 54";326;287;613
"5312";"quemchi";"55 a 59";269;251;520
"5313";"quemchi";"60 a 64";234;204;438
"5314";"quemchi";"65 a 69";179;196;375
"5315";"quemchi";"70 a 74";168;150;318
"5316";"quemchi";"75 a 79";122;129;251
"5317";"quemchi";"80 a 84";76;98;174
"5318";"quemchi";"85 a 89";48;72;120
"5319";"quemchi";"90 a 94";14;29;43
"5320";"quemchi";"95 a 99";4;6;10
"5321";"quemchi";"100 o más";1;1;2
"5322";"quinchao";"20 a 24";227;198;425
"5323";"quinchao";"25 a 29";261;262;523
"5324";"quinchao";"30 a 34";299;282;581
"5325";"quinchao";"35 a 39";269;296;565
"5326";"quinchao";"40 a 44";329;294;623
"5327";"quinchao";"45 a 49";311;283;594
"5328";"quinchao";"50 a 54";309;262;571
"5329";"quinchao";"55 a 59";221;248;469
"5330";"quinchao";"60 a 64";191;232;423
"5331";"quinchao";"65 a 69";164;210;374
"5332";"quinchao";"70 a 74";133;180;313
"5333";"quinchao";"75 a 79";92;144;236
"5334";"quinchao";"80 a 84";52;88;140
"5335";"quinchao";"85 a 89";29;61;90
"5336";"quinchao";"90 a 94";12;40;52
"5337";"quinchao";"95 a 99";2;8;10
"5338";"quinchao";"100 o más";1;2;3
"5339";"osorno";"20 a 24";5824;5888;11712
"5340";"osorno";"25 a 29";6251;6560;12811
"5341";"osorno";"30 a 34";5783;5861;11644
"5342";"osorno";"35 a 39";5322;5854;11176
"5343";"osorno";"40 a 44";5576;6198;11774
"5344";"osorno";"45 a 49";5089;5778;10867
"5345";"osorno";"50 a 54";5210;5711;10921
"5346";"osorno";"55 a 59";4525;5088;9613
"5347";"osorno";"60 a 64";3499;4140;7639
"5348";"osorno";"65 a 69";2599;3365;5964
"5349";"osorno";"70 a 74";2035;2731;4766
"5350";"osorno";"75 a 79";1439;2071;3510
"5351";"osorno";"80 a 84";895;1456;2351
"5352";"osorno";"85 a 89";499;1002;1501
"5353";"osorno";"90 a 94";185;423;608
"5354";"osorno";"95 a 99";37;120;157
"5355";"osorno";"100 o más";15;35;50
"5356";"puerto octay";"20 a 24";346;292;638
"5357";"puerto octay";"25 a 29";314;310;624
"5358";"puerto octay";"30 a 34";268;250;518
"5359";"puerto octay";"35 a 39";295;284;579
"5360";"puerto octay";"40 a 44";304;281;585
"5361";"puerto octay";"45 a 49";352;319;671
"5362";"puerto octay";"50 a 54";401;319;720
"5363";"puerto octay";"55 a 59";326;295;621
"5364";"puerto octay";"60 a 64";279;240;519
"5365";"puerto octay";"65 a 69";200;173;373
"5366";"puerto octay";"70 a 74";144;136;280
"5367";"puerto octay";"75 a 79";131;112;243
"5368";"puerto octay";"80 a 84";55;77;132
"5369";"puerto octay";"85 a 89";28;45;73
"5370";"puerto octay";"90 a 94";14;10;24
"5371";"puerto octay";"95 a 99";3;2;5
"5372";"puerto octay";"100 o más";1;1;2
"5373";"purranque";"20 a 24";650;702;1352
"5374";"purranque";"25 a 29";733;719;1452
"5375";"purranque";"30 a 34";567;622;1189
"5376";"purranque";"35 a 39";551;567;1118
"5377";"purranque";"40 a 44";654;659;1313
"5378";"purranque";"45 a 49";677;741;1418
"5379";"purranque";"50 a 54";770;767;1537
"5380";"purranque";"55 a 59";658;700;1358
"5381";"purranque";"60 a 64";530;557;1087
"5382";"purranque";"65 a 69";436;491;927
"5383";"purranque";"70 a 74";355;402;757
"5384";"purranque";"75 a 79";260;306;566
"5385";"purranque";"80 a 84";176;253;429
"5386";"purranque";"85 a 89";93;151;244
"5387";"purranque";"90 a 94";45;54;99
"5388";"purranque";"95 a 99";7;7;14
"5389";"purranque";"100 o más";2;0;2
"5390";"puyehue";"20 a 24";393;367;760
"5391";"puyehue";"25 a 29";362;365;727
"5392";"puyehue";"30 a 34";351;350;701
"5393";"puyehue";"35 a 39";344;348;692
"5394";"puyehue";"40 a 44";442;382;824
"5395";"puyehue";"45 a 49";412;434;846
"5396";"puyehue";"50 a 54";468;424;892
"5397";"puyehue";"55 a 59";383;377;760
"5398";"puyehue";"60 a 64";325;322;647
"5399";"puyehue";"65 a 69";268;251;519
"5400";"puyehue";"70 a 74";221;203;424
"5401";"puyehue";"75 a 79";164;146;310
"5402";"puyehue";"80 a 84";89;99;188
"5403";"puyehue";"85 a 89";54;69;123
"5404";"puyehue";"90 a 94";18;25;43
"5405";"puyehue";"95 a 99";4;4;8
"5406";"puyehue";"100 o más";2;3;5
"5407";"río negro";"20 a 24";449;406;855
"5408";"río negro";"25 a 29";422;486;908
"5409";"río negro";"30 a 34";408;427;835
"5410";"río negro";"35 a 39";361;402;763
"5411";"río negro";"40 a 44";467;449;916
"5412";"río negro";"45 a 49";523;477;1000
"5413";"río negro";"50 a 54";537;499;1036
"5414";"río negro";"55 a 59";489;505;994
"5415";"río negro";"60 a 64";419;403;822
"5416";"río negro";"65 a 69";353;339;692
"5417";"río negro";"70 a 74";275;274;549
"5418";"río negro";"75 a 79";199;197;396
"5419";"río negro";"80 a 84";111;154;265
"5420";"río negro";"85 a 89";65;102;167
"5421";"río negro";"90 a 94";30;42;72
"5422";"río negro";"95 a 99";6;8;14
"5423";"río negro";"100 o más";0;4;4
"5424";"san juan de la costa";"20 a 24";203;189;392
"5425";"san juan de la costa";"25 a 29";174;174;348
"5426";"san juan de la costa";"30 a 34";186;177;363
"5427";"san juan de la costa";"35 a 39";269;232;501
"5428";"san juan de la costa";"40 a 44";328;298;626
"5429";"san juan de la costa";"45 a 49";295;252;547
"5430";"san juan de la costa";"50 a 54";320;269;589
"5431";"san juan de la costa";"55 a 59";300;264;564
"5432";"san juan de la costa";"60 a 64";277;201;478
"5433";"san juan de la costa";"65 a 69";233;191;424
"5434";"san juan de la costa";"70 a 74";178;158;336
"5435";"san juan de la costa";"75 a 79";149;124;273
"5436";"san juan de la costa";"80 a 84";113;81;194
"5437";"san juan de la costa";"85 a 89";56;46;102
"5438";"san juan de la costa";"90 a 94";15;17;32
"5439";"san juan de la costa";"95 a 99";5;3;8
"5440";"san juan de la costa";"100 o más";1;1;2
"5441";"san pablo";"20 a 24";267;319;586
"5442";"san pablo";"25 a 29";306;287;593
"5443";"san pablo";"30 a 34";255;297;552
"5444";"san pablo";"35 a 39";294;308;602
"5445";"san pablo";"40 a 44";315;344;659
"5446";"san pablo";"45 a 49";315;378;693
"5447";"san pablo";"50 a 54";447;369;816
"5448";"san pablo";"55 a 59";351;310;661
"5449";"san pablo";"60 a 64";323;346;669
"5450";"san pablo";"65 a 69";258;240;498
"5451";"san pablo";"70 a 74";201;215;416
"5452";"san pablo";"75 a 79";165;176;341
"5453";"san pablo";"80 a 84";98;97;195
"5454";"san pablo";"85 a 89";59;79;138
"5455";"san pablo";"90 a 94";19;29;48
"5456";"san pablo";"95 a 99";3;8;11
"5457";"san pablo";"100 o más";0;3;3
"5458";"chaitén";"20 a 24";180;93;273
"5459";"chaitén";"25 a 29";267;169;436
"5460";"chaitén";"30 a 34";241;143;384
"5461";"chaitén";"35 a 39";284;159;443
"5462";"chaitén";"40 a 44";296;173;469
"5463";"chaitén";"45 a 49";261;149;410
"5464";"chaitén";"50 a 54";234;143;377
"5465";"chaitén";"55 a 59";207;139;346
"5466";"chaitén";"60 a 64";168;127;295
"5467";"chaitén";"65 a 69";79;80;159
"5468";"chaitén";"70 a 74";77;65;142
"5469";"chaitén";"75 a 79";46;44;90
"5470";"chaitén";"80 a 84";42;25;67
"5471";"chaitén";"85 a 89";15;13;28
"5472";"chaitén";"90 a 94";4;8;12
"5473";"chaitén";"95 a 99";0;2;2
"5474";"chaitén";"100 o más";1;0;1
"5475";"futaleufú";"20 a 24";89;67;156
"5476";"futaleufú";"25 a 29";125;124;249
"5477";"futaleufú";"30 a 34";118;103;221
"5478";"futaleufú";"35 a 39";103;88;191
"5479";"futaleufú";"40 a 44";102;90;192
"5480";"futaleufú";"45 a 49";115;90;205
"5481";"futaleufú";"50 a 54";110;91;201
"5482";"futaleufú";"55 a 59";90;69;159
"5483";"futaleufú";"60 a 64";69;52;121
"5484";"futaleufú";"65 a 69";47;44;91
"5485";"futaleufú";"70 a 74";38;48;86
"5486";"futaleufú";"75 a 79";42;33;75
"5487";"futaleufú";"80 a 84";14;18;32
"5488";"futaleufú";"85 a 89";9;12;21
"5489";"futaleufú";"90 a 94";5;4;9
"5490";"futaleufú";"95 a 99";2;2;4
"5491";"futaleufú";"100 o más";0;0;0
"5492";"hualaihué";"20 a 24";257;219;476
"5493";"hualaihué";"25 a 29";323;311;634
"5494";"hualaihué";"30 a 34";310;349;659
"5495";"hualaihué";"35 a 39";350;307;657
"5496";"hualaihué";"40 a 44";350;316;666
"5497";"hualaihué";"45 a 49";384;336;720
"5498";"hualaihué";"50 a 54";370;294;664
"5499";"hualaihué";"55 a 59";299;233;532
"5500";"hualaihué";"60 a 64";244;187;431
"5501";"hualaihué";"65 a 69";169;150;319
"5502";"hualaihué";"70 a 74";138;121;259
"5503";"hualaihué";"75 a 79";88;91;179
"5504";"hualaihué";"80 a 84";62;56;118
"5505";"hualaihué";"85 a 89";36;42;78
"5506";"hualaihué";"90 a 94";14;12;26
"5507";"hualaihué";"95 a 99";3;3;6
"5508";"hualaihué";"100 o más";0;1;1
"5509";"palena";"20 a 24";37;33;70
"5510";"palena";"25 a 29";67;76;143
"5511";"palena";"30 a 34";68;53;121
"5512";"palena";"35 a 39";58;60;118
"5513";"palena";"40 a 44";60;65;125
"5514";"palena";"45 a 49";63;51;114
"5515";"palena";"50 a 54";78;65;143
"5516";"palena";"55 a 59";53;43;96
"5517";"palena";"60 a 64";73;50;123
"5518";"palena";"65 a 69";47;32;79
"5519";"palena";"70 a 74";31;45;76
"5520";"palena";"75 a 79";23;22;45
"5521";"palena";"80 a 84";12;19;31
"5522";"palena";"85 a 89";9;7;16
"5523";"palena";"90 a 94";6;4;10
"5524";"palena";"95 a 99";1;6;7
"5525";"palena";"100 o más";0;0;0
"5526";"coyhaique";"20 a 24";1724;1656;3380
"5527";"coyhaique";"25 a 29";2216;2394;4610
"5528";"coyhaique";"30 a 34";2123;2277;4400
"5529";"coyhaique";"35 a 39";2253;2278;4531
"5530";"coyhaique";"40 a 44";2076;2230;4306
"5531";"coyhaique";"45 a 49";1918;1960;3878
"5532";"coyhaique";"50 a 54";1797;1802;3599
"5533";"coyhaique";"55 a 59";1602;1655;3257
"5534";"coyhaique";"60 a 64";1293;1341;2634
"5535";"coyhaique";"65 a 69";906;912;1818
"5536";"coyhaique";"70 a 74";638;644;1282
"5537";"coyhaique";"75 a 79";436;503;939
"5538";"coyhaique";"80 a 84";255;336;591
"5539";"coyhaique";"85 a 89";132;215;347
"5540";"coyhaique";"90 a 94";44;81;125
"5541";"coyhaique";"95 a 99";9;18;27
"5542";"coyhaique";"100 o más";5;14;19
"5543";"lago verde";"20 a 24";27;19;46
"5544";"lago verde";"25 a 29";38;33;71
"5545";"lago verde";"30 a 34";32;22;54
"5546";"lago verde";"35 a 39";33;24;57
"5547";"lago verde";"40 a 44";31;27;58
"5548";"lago verde";"45 a 49";32;26;58
"5549";"lago verde";"50 a 54";51;38;89
"5550";"lago verde";"55 a 59";34;24;58
"5551";"lago verde";"60 a 64";44;16;60
"5552";"lago verde";"65 a 69";28;22;50
"5553";"lago verde";"70 a 74";11;16;27
"5554";"lago verde";"75 a 79";13;5;18
"5555";"lago verde";"80 a 84";5;7;12
"5556";"lago verde";"85 a 89";6;2;8
"5557";"lago verde";"90 a 94";1;1;2
"5558";"lago verde";"95 a 99";1;0;1
"5559";"lago verde";"100 o más";0;1;1
"5560";"aysén";"20 a 24";772;666;1438
"5561";"aysén";"25 a 29";1127;1015;2142
"5562";"aysén";"30 a 34";1026;904;1930
"5563";"aysén";"35 a 39";987;850;1837
"5564";"aysén";"40 a 44";1014;776;1790
"5565";"aysén";"45 a 49";871;711;1582
"5566";"aysén";"50 a 54";872;797;1669
"5567";"aysén";"55 a 59";713;635;1348
"5568";"aysén";"60 a 64";507;472;979
"5569";"aysén";"65 a 69";360;352;712
"5570";"aysén";"70 a 74";275;233;508
"5571";"aysén";"75 a 79";201;223;424
"5572";"aysén";"80 a 84";114;115;229
"5573";"aysén";"85 a 89";41;75;116
"5574";"aysén";"90 a 94";17;40;57
"5575";"aysén";"95 a 99";3;8;11
"5576";"aysén";"100 o más";0;3;3
"5577";"cisnes";"20 a 24";215;155;370
"5578";"cisnes";"25 a 29";418;257;675
"5579";"cisnes";"30 a 34";395;235;630
"5580";"cisnes";"35 a 39";356;213;569
"5581";"cisnes";"40 a 44";398;166;564
"5582";"cisnes";"45 a 49";351;192;543
"5583";"cisnes";"50 a 54";366;171;537
"5584";"cisnes";"55 a 59";216;136;352
"5585";"cisnes";"60 a 64";170;116;286
"5586";"cisnes";"65 a 69";102;90;192
"5587";"cisnes";"70 a 74";61;43;104
"5588";"cisnes";"75 a 79";39;39;78
"5589";"cisnes";"80 a 84";29;21;50
"5590";"cisnes";"85 a 89";13;22;35
"5591";"cisnes";"90 a 94";3;4;7
"5592";"cisnes";"95 a 99";0;3;3
"5593";"cisnes";"100 o más";1;0;1
"5594";"guaitecas";"20 a 24";81;36;117
"5595";"guaitecas";"25 a 29";128;75;203
"5596";"guaitecas";"30 a 34";136;54;190
"5597";"guaitecas";"35 a 39";130;60;190
"5598";"guaitecas";"40 a 44";109;47;156
"5599";"guaitecas";"45 a 49";118;50;168
"5600";"guaitecas";"50 a 54";88;39;127
"5601";"guaitecas";"55 a 59";55;31;86
"5602";"guaitecas";"60 a 64";41;22;63
"5603";"guaitecas";"65 a 69";28;24;52
"5604";"guaitecas";"70 a 74";13;10;23
"5605";"guaitecas";"75 a 79";13;10;23
"5606";"guaitecas";"80 a 84";11;4;15
"5607";"guaitecas";"85 a 89";2;1;3
"5608";"guaitecas";"90 a 94";1;2;3
"5609";"guaitecas";"95 a 99";1;0;1
"5610";"guaitecas";"100 o más";0;0;0
"5611";"cochrane";"20 a 24";161;80;241
"5612";"cochrane";"25 a 29";142;149;291
"5613";"cochrane";"30 a 34";179;144;323
"5614";"cochrane";"35 a 39";140;144;284
"5615";"cochrane";"40 a 44";142;110;252
"5616";"cochrane";"45 a 49";134;100;234
"5617";"cochrane";"50 a 54";119;89;208
"5618";"cochrane";"55 a 59";118;76;194
"5619";"cochrane";"60 a 64";86;80;166
"5620";"cochrane";"65 a 69";54;45;99
"5621";"cochrane";"70 a 74";39;45;84
"5622";"cochrane";"75 a 79";40;39;79
"5623";"cochrane";"80 a 84";19;21;40
"5624";"cochrane";"85 a 89";5;9;14
"5625";"cochrane";"90 a 94";4;1;5
"5626";"cochrane";"95 a 99";1;4;5
"5627";"cochrane";"100 o más";0;2;2
"5628";"o'higgins";"20 a 24";23;17;40
"5629";"o'higgins";"25 a 29";44;40;84
"5630";"o'higgins";"30 a 34";43;23;66
"5631";"o'higgins";"35 a 39";29;17;46
"5632";"o'higgins";"40 a 44";36;16;52
"5633";"o'higgins";"45 a 49";26;18;44
"5634";"o'higgins";"50 a 54";22;11;33
"5635";"o'higgins";"55 a 59";33;14;47
"5636";"o'higgins";"60 a 64";20;6;26
"5637";"o'higgins";"65 a 69";13;5;18
"5638";"o'higgins";"70 a 74";10;4;14
"5639";"o'higgins";"75 a 79";4;1;5
"5640";"o'higgins";"80 a 84";2;1;3
"5641";"o'higgins";"85 a 89";1;1;2
"5642";"o'higgins";"90 a 94";0;0;0
"5643";"o'higgins";"95 a 99";0;0;0
"5644";"o'higgins";"100 o más";0;1;1
"5645";"tortel";"20 a 24";15;18;33
"5646";"tortel";"25 a 29";28;24;52
"5647";"tortel";"30 a 34";32;27;59
"5648";"tortel";"35 a 39";25;20;45
"5649";"tortel";"40 a 44";27;12;39
"5650";"tortel";"45 a 49";27;14;41
"5651";"tortel";"50 a 54";18;20;38
"5652";"tortel";"55 a 59";21;7;28
"5653";"tortel";"60 a 64";12;4;16
"5654";"tortel";"65 a 69";5;9;14
"5655";"tortel";"70 a 74";7;5;12
"5656";"tortel";"75 a 79";0;2;2
"5657";"tortel";"80 a 84";4;1;5
"5658";"tortel";"85 a 89";0;1;1
"5659";"tortel";"90 a 94";1;0;1
"5660";"tortel";"95 a 99";0;0;0
"5661";"tortel";"100 o más";0;0;0
"5662";"chile chico";"20 a 24";135;110;245
"5663";"chile chico";"25 a 29";197;172;369
"5664";"chile chico";"30 a 34";229;197;426
"5665";"chile chico";"35 a 39";187;186;373
"5666";"chile chico";"40 a 44";177;146;323
"5667";"chile chico";"45 a 49";197;172;369
"5668";"chile chico";"50 a 54";202;147;349
"5669";"chile chico";"55 a 59";204;149;353
"5670";"chile chico";"60 a 64";163;127;290
"5671";"chile chico";"65 a 69";80;90;170
"5672";"chile chico";"70 a 74";80;67;147
"5673";"chile chico";"75 a 79";59;60;119
"5674";"chile chico";"80 a 84";34;42;76
"5675";"chile chico";"85 a 89";17;21;38
"5676";"chile chico";"90 a 94";4;7;11
"5677";"chile chico";"95 a 99";1;2;3
"5678";"chile chico";"100 o más";1;0;1
"5679";"río ibáñez";"20 a 24";72;59;131
"5680";"río ibáñez";"25 a 29";118;122;240
"5681";"río ibáñez";"30 a 34";114;110;224
"5682";"río ibáñez";"35 a 39";80;77;157
"5683";"río ibáñez";"40 a 44";101;67;168
"5684";"río ibáñez";"45 a 49";107;93;200
"5685";"río ibáñez";"50 a 54";118;84;202
"5686";"río ibáñez";"55 a 59";105;76;181
"5687";"río ibáñez";"60 a 64";113;74;187
"5688";"río ibáñez";"65 a 69";65;68;133
"5689";"río ibáñez";"70 a 74";57;53;110
"5690";"río ibáñez";"75 a 79";37;26;63
"5691";"río ibáñez";"80 a 84";23;28;51
"5692";"río ibáñez";"85 a 89";14;16;30
"5693";"río ibáñez";"90 a 94";6;7;13
"5694";"río ibáñez";"95 a 99";1;1;2
"5695";"río ibáñez";"100 o más";0;0;0
"5696";"punta arenas";"20 a 24";4724;4289;9013
"5697";"punta arenas";"25 a 29";5242;5124;10366
"5698";"punta arenas";"30 a 34";5199;5025;10224
"5699";"punta arenas";"35 a 39";4882;4822;9704
"5700";"punta arenas";"40 a 44";4722;4656;9378
"5701";"punta arenas";"45 a 49";4090;4244;8334
"5702";"punta arenas";"50 a 54";4241;4654;8895
"5703";"punta arenas";"55 a 59";4226;4352;8578
"5704";"punta arenas";"60 a 64";3385;3593;6978
"5705";"punta arenas";"65 a 69";2479;2663;5142
"5706";"punta arenas";"70 a 74";1893;2189;4082
"5707";"punta arenas";"75 a 79";1211;1655;2866
"5708";"punta arenas";"80 a 84";694;1176;1870
"5709";"punta arenas";"85 a 89";373;691;1064
"5710";"punta arenas";"90 a 94";137;296;433
"5711";"punta arenas";"95 a 99";34;106;140
"5712";"punta arenas";"100 o más";11;20;31
"5713";"laguna blanca";"20 a 24";10;2;12
"5714";"laguna blanca";"25 a 29";7;8;15
"5715";"laguna blanca";"30 a 34";13;7;20
"5716";"laguna blanca";"35 a 39";18;3;21
"5717";"laguna blanca";"40 a 44";16;6;22
"5718";"laguna blanca";"45 a 49";16;5;21
"5719";"laguna blanca";"50 a 54";22;9;31
"5720";"laguna blanca";"55 a 59";15;3;18
"5721";"laguna blanca";"60 a 64";23;6;29
"5722";"laguna blanca";"65 a 69";13;2;15
"5723";"laguna blanca";"70 a 74";5;2;7
"5724";"laguna blanca";"75 a 79";3;2;5
"5725";"laguna blanca";"80 a 84";0;2;2
"5726";"laguna blanca";"85 a 89";0;0;0
"5727";"laguna blanca";"90 a 94";0;0;0
"5728";"laguna blanca";"95 a 99";0;0;0
"5729";"laguna blanca";"100 o más";0;0;0
"5730";"río verde";"20 a 24";44;9;53
"5731";"río verde";"25 a 29";59;16;75
"5732";"río verde";"30 a 34";77;11;88
"5733";"río verde";"35 a 39";60;5;65
"5734";"río verde";"40 a 44";61;8;69
"5735";"río verde";"45 a 49";55;8;63
"5736";"río verde";"50 a 54";55;7;62
"5737";"río verde";"55 a 59";34;10;44
"5738";"río verde";"60 a 64";39;4;43
"5739";"río verde";"65 a 69";14;3;17
"5740";"río verde";"70 a 74";6;4;10
"5741";"río verde";"75 a 79";3;0;3
"5742";"río verde";"80 a 84";2;0;2
"5743";"río verde";"85 a 89";1;0;1
"5744";"río verde";"90 a 94";0;0;0
"5745";"río verde";"95 a 99";0;0;0
"5746";"río verde";"100 o más";0;0;0
"5747";"san gregorio";"20 a 24";25;7;32
"5748";"san gregorio";"25 a 29";67;22;89
"5749";"san gregorio";"30 a 34";78;22;100
"5750";"san gregorio";"35 a 39";54;12;66
"5751";"san gregorio";"40 a 44";66;6;72
"5752";"san gregorio";"45 a 49";55;13;68
"5753";"san gregorio";"50 a 54";54;22;76
"5754";"san gregorio";"55 a 59";77;16;93
"5755";"san gregorio";"60 a 64";60;12;72
"5756";"san gregorio";"65 a 69";21;4;25
"5757";"san gregorio";"70 a 74";19;0;19
"5758";"san gregorio";"75 a 79";3;2;5
"5759";"san gregorio";"80 a 84";1;0;1
"5760";"san gregorio";"85 a 89";0;1;1
"5761";"san gregorio";"90 a 94";0;0;0
"5762";"san gregorio";"95 a 99";0;0;0
"5763";"san gregorio";"100 o más";0;0;0
"5764";"cabo de hornos";"20 a 24";100;46;146
"5765";"cabo de hornos";"25 a 29";124;97;221
"5766";"cabo de hornos";"30 a 34";140;112;252
"5767";"cabo de hornos";"35 a 39";127;83;210
"5768";"cabo de hornos";"40 a 44";115;71;186
"5769";"cabo de hornos";"45 a 49";89;37;126
"5770";"cabo de hornos";"50 a 54";75;35;110
"5771";"cabo de hornos";"55 a 59";63;27;90
"5772";"cabo de hornos";"60 a 64";31;22;53
"5773";"cabo de hornos";"65 a 69";19;14;33
"5774";"cabo de hornos";"70 a 74";12;6;18
"5775";"cabo de hornos";"75 a 79";3;3;6
"5776";"cabo de hornos";"80 a 84";2;2;4
"5777";"cabo de hornos";"85 a 89";1;3;4
"5778";"cabo de hornos";"90 a 94";0;0;0
"5779";"cabo de hornos";"95 a 99";0;0;0
"5780";"cabo de hornos";"100 o más";0;0;0
"5781";"antártica";"20 a 24";2;0;2
"5782";"antártica";"25 a 29";14;0;14
"5783";"antártica";"30 a 34";19;2;21
"5784";"antártica";"35 a 39";35;4;39
"5785";"antártica";"40 a 44";21;0;21
"5786";"antártica";"45 a 49";20;2;22
"5787";"antártica";"50 a 54";8;0;8
"5788";"antártica";"55 a 59";1;0;1
"5789";"antártica";"60 a 64";2;0;2
"5790";"antártica";"65 a 69";0;0;0
"5791";"antártica";"70 a 74";0;0;0
"5792";"antártica";"75 a 79";0;0;0
"5793";"antártica";"80 a 84";0;0;0
"5794";"antártica";"85 a 89";0;0;0
"5795";"antártica";"90 a 94";0;0;0
"5796";"antártica";"95 a 99";0;0;0
"5797";"antártica";"100 o más";0;0;0
"5798";"porvenir";"20 a 24";295;173;468
"5799";"porvenir";"25 a 29";388;295;683
"5800";"porvenir";"30 a 34";323;258;581
"5801";"porvenir";"35 a 39";281;194;475
"5802";"porvenir";"40 a 44";279;182;461
"5803";"porvenir";"45 a 49";254;196;450
"5804";"porvenir";"50 a 54";250;186;436
"5805";"porvenir";"55 a 59";271;153;424
"5806";"porvenir";"60 a 64";194;144;338
"5807";"porvenir";"65 a 69";135;104;239
"5808";"porvenir";"70 a 74";104;60;164
"5809";"porvenir";"75 a 79";69;57;126
"5810";"porvenir";"80 a 84";38;35;73
"5811";"porvenir";"85 a 89";15;22;37
"5812";"porvenir";"90 a 94";3;10;13
"5813";"porvenir";"95 a 99";1;3;4
"5814";"porvenir";"100 o más";1;2;3
"5815";"primavera";"20 a 24";39;11;50
"5816";"primavera";"25 a 29";112;24;136
"5817";"primavera";"30 a 34";113;34;147
"5818";"primavera";"35 a 39";111;19;130
"5819";"primavera";"40 a 44";86;11;97
"5820";"primavera";"45 a 49";91;20;111
"5821";"primavera";"50 a 54";101;24;125
"5822";"primavera";"55 a 59";96;14;110
"5823";"primavera";"60 a 64";91;8;99
"5824";"primavera";"65 a 69";23;7;30
"5825";"primavera";"70 a 74";10;6;16
"5826";"primavera";"75 a 79";3;2;5
"5827";"primavera";"80 a 84";1;0;1
"5828";"primavera";"85 a 89";0;0;0
"5829";"primavera";"90 a 94";0;0;0
"5830";"primavera";"95 a 99";0;0;0
"5831";"primavera";"100 o más";0;0;0
"5832";"timaukel";"20 a 24";27;4;31
"5833";"timaukel";"25 a 29";41;9;50
"5834";"timaukel";"30 a 34";40;10;50
"5835";"timaukel";"35 a 39";27;3;30
"5836";"timaukel";"40 a 44";29;8;37
"5837";"timaukel";"45 a 49";46;3;49
"5838";"timaukel";"50 a 54";36;2;38
"5839";"timaukel";"55 a 59";31;8;39
"5840";"timaukel";"60 a 64";19;0;19
"5841";"timaukel";"65 a 69";13;2;15
"5842";"timaukel";"70 a 74";4;1;5
"5843";"timaukel";"75 a 79";3;0;3
"5844";"timaukel";"80 a 84";0;1;1
"5845";"timaukel";"85 a 89";0;0;0
"5846";"timaukel";"90 a 94";0;0;0
"5847";"timaukel";"95 a 99";0;0;0
"5848";"timaukel";"100 o más";1;0;1
"5849";"natales";"20 a 24";661;631;1292
"5850";"natales";"25 a 29";930;949;1879
"5851";"natales";"30 a 34";898;818;1716
"5852";"natales";"35 a 39";864;809;1673
"5853";"natales";"40 a 44";843;752;1595
"5854";"natales";"45 a 49";706;666;1372
"5855";"natales";"50 a 54";658;675;1333
"5856";"natales";"55 a 59";627;591;1218
"5857";"natales";"60 a 64";575;576;1151
"5858";"natales";"65 a 69";483;432;915
"5859";"natales";"70 a 74";343;363;706
"5860";"natales";"75 a 79";248;270;518
"5861";"natales";"80 a 84";146;187;333
"5862";"natales";"85 a 89";72;110;182
"5863";"natales";"90 a 94";29;49;78
"5864";"natales";"95 a 99";8;15;23
"5865";"natales";"100 o más";1;2;3
"5866";"torres del paine";"20 a 24";89;76;165
"5867";"torres del paine";"25 a 29";161;104;265
"5868";"torres del paine";"30 a 34";120;68;188
"5869";"torres del paine";"35 a 39";80;29;109
"5870";"torres del paine";"40 a 44";53;23;76
"5871";"torres del paine";"45 a 49";59;17;76
"5872";"torres del paine";"50 a 54";53;17;70
"5873";"torres del paine";"55 a 59";47;16;63
"5874";"torres del paine";"60 a 64";39;7;46
"5875";"torres del paine";"65 a 69";27;8;35
"5876";"torres del paine";"70 a 74";18;8;26
"5877";"torres del paine";"75 a 79";12;2;14
"5878";"torres del paine";"80 a 84";2;2;4
"5879";"torres del paine";"85 a 89";0;1;1
"5880";"torres del paine";"90 a 94";0;0;0
"5881";"torres del paine";"95 a 99";0;0;0
"5882";"torres del paine";"100 o más";0;0;0
"5883";"arica";"18 a 19";3667;3203;6870
"5884";"camarones";"18 a 19";12;8;20
"5885";"putre";"18 a 19";186;11;197
"5886";"general lagos";"18 a 19";11;6;17
"5887";"iquique";"18 a 19";2639;2480;5119
"5888";"alto hospicio";"18 a 19";1934;1907;3841
"5889";"pozo almonte";"18 a 19";339;217;556
"5890";"camiña";"18 a 19";18;18;36
"5891";"colchane";"18 a 19";28;16;44
"5892";"huara";"18 a 19";30;28;58
"5893";"pica";"18 a 19";71;62;133
"5894";"antofagasta";"18 a 19";5658;5234;10892
"5895";"mejillones";"18 a 19";159;158;317
"5896";"sierra gorda";"18 a 19";25;19;44
"5897";"taltal";"18 a 19";164;154;318
"5898";"calama";"18 a 19";2538;2220;4758
"5899";"ollagüe";"18 a 19";3;2;5
"5900";"san pedro de atacama";"18 a 19";87;104;191
"5901";"tocopilla";"18 a 19";365;340;705
"5902";"maría elena";"18 a 19";63;66;129
"5903";"copiapó";"18 a 19";2418;2226;4644
"5904";"caldera";"18 a 19";259;237;496
"5905";"tierra amarilla";"18 a 19";206;189;395
"5906";"chañaral";"18 a 19";178;151;329
"5907";"diego de almagro";"18 a 19";184;177;361
"5908";"vallenar";"18 a 19";696;658;1354
"5909";"alto del carmen";"18 a 19";49;52;101
"5910";"freirina";"18 a 19";82;83;165
"5911";"huasco";"18 a 19";115;114;229
"5912";"la serena";"18 a 19";3656;3390;7046
"5913";"coquimbo";"18 a 19";3420;3369;6789
"5914";"andacollo";"18 a 19";158;131;289
"5915";"la higuera";"18 a 19";59;46;105
"5916";"paiguano";"18 a 19";52;49;101
"5917";"vicuña";"18 a 19";396;384;780
"5918";"illapel";"18 a 19";437;413;850
"5919";"canela";"18 a 19";97;86;183
"5920";"los vilos";"18 a 19";260;227;487
"5921";"salamanca";"18 a 19";342;308;650
"5922";"ovalle";"18 a 19";1584;1582;3166
"5923";"combarbalá";"18 a 19";135;132;267
"5924";"monte patria";"18 a 19";435;408;843
"5925";"punitaqui";"18 a 19";139;146;285
"5926";"río hurtado";"18 a 19";44;42;86
"5927";"valparaíso";"18 a 19";4516;4288;8804
"5928";"casablanca";"18 a 19";374;386;760
"5929";"concón";"18 a 19";648;659;1307
"5930";"juan fernández";"18 a 19";8;10;18
"5931";"puchuncaví";"18 a 19";240;226;466
"5932";"quintero";"18 a 19";460;468;928
"5933";"viña del mar";"18 a 19";5071;4907;9978
"5934";"isla de pascua";"18 a 19";94;75;169
"5935";"los andes";"18 a 19";1047;907;1954
"5936";"calle larga";"18 a 19";216;191;407
"5937";"rinconada";"18 a 19";144;125;269
"5938";"san esteban";"18 a 19";266;240;506
"5939";"la ligua";"18 a 19";465;422;887
"5940";"cabildo";"18 a 19";271;260;531
"5941";"papudo";"18 a 19";188;113;301
"5942";"petorca";"18 a 19";113;114;227
"5943";"zapallar";"18 a 19";93;85;178
"5944";"quillota";"18 a 19";1360;1246;2606
"5945";"calera";"18 a 19";787;740;1527
"5946";"hijuelas";"18 a 19";272;239;511
"5947";"la cruz";"18 a 19";318;302;620
"5948";"nogales";"18 a 19";356;318;674
"5949";"san antonio";"18 a 19";1230;1237;2467
"5950";"algarrobo";"18 a 19";166;151;317
"5951";"cartagena";"18 a 19";289;280;569
"5952";"el quisco";"18 a 19";186;171;357
"5953";"el tabo";"18 a 19";144;125;269
"5954";"santo domingo";"18 a 19";138;122;260
"5955";"san felipe";"18 a 19";1080;1029;2109
"5956";"catemu";"18 a 19";198;179;377
"5957";"llaillay";"18 a 19";318;336;654
"5958";"panquehue";"18 a 19";98;94;192
"5959";"putaendo";"18 a 19";235;218;453
"5960";"santa maría";"18 a 19";218;209;427
"5961";"quilpué";"18 a 19";2212;2137;4349
"5962";"limache";"18 a 19";690;638;1328
"5963";"olmué";"18 a 19";240;232;472
"5964";"villa alemana";"18 a 19";1912;1859;3771
"5965";"santiago";"18 a 19";3642;3496;7138
"5966";"cerrillos";"18 a 19";1195;1150;2345
"5967";"cerro navia";"18 a 19";1977;1910;3887
"5968";"conchalí";"18 a 19";1726;1697;3423
"5969";"el bosque";"18 a 19";2361;2350;4711
"5970";"estación central";"18 a 19";1790;1692;3482
"5971";"huechuraba";"18 a 19";1502;1515;3017
"5972";"independencia";"18 a 19";1170;1037;2207
"5973";"la cisterna";"18 a 19";1136;1139;2275
"5974";"la florida";"18 a 19";5032;4906;9938
"5975";"la granja";"18 a 19";1678;1656;3334
"5976";"la pintana";"18 a 19";2750;2822;5572
"5977";"la reina";"18 a 19";1408;1278;2686
"5978";"las condes";"18 a 19";3678;3605;7283
"5979";"lo barnechea";"18 a 19";1888;1877;3765
"5980";"lo espejo";"18 a 19";1406;1398;2804
"5981";"lo prado";"18 a 19";1280;1299;2579
"5982";"macul";"18 a 19";1481;1370;2851
"5983";"maipú";"18 a 19";8112;7889;16001
"5984";"ñuñoa";"18 a 19";2098;2120;4218
"5985";"pedro aguirre cerda";"18 a 19";1319;1298;2617
"5986";"peñalolén";"18 a 19";3773;3753;7526
"5987";"providencia";"18 a 19";1213;1196;2409
"5988";"pudahuel";"18 a 19";3444;3274;6718
"5989";"quilicura";"18 a 19";3536;3461;6997
"5990";"quinta normal";"18 a 19";1458;1428;2886
"5991";"recoleta";"18 a 19";2102;2039;4141
"5992";"renca";"18 a 19";2269;2182;4451
"5993";"san joaquín";"18 a 19";1325;1182;2507
"5994";"san miguel";"18 a 19";1163;1204;2367
"5995";"san ramón";"18 a 19";1205;1184;2389
"5996";"vitacura";"18 a 19";1060;1096;2156
"5997";"puente alto";"18 a 19";8918;8703;17621
"5998";"pirque";"18 a 19";390;367;757
"5999";"san josé de maipo";"18 a 19";229;219;448
"6000";"colina";"18 a 19";2292;2166;4458
"6001";"lampa";"18 a 19";1562;1512;3074
"6002";"tiltil";"18 a 19";316;267;583
"6003";"san bernardo";"18 a 19";4889;4715;9604
"6004";"buin";"18 a 19";1430;1396;2826
"6005";"calera de tango";"18 a 19";412;369;781
"6006";"paine";"18 a 19";1104;1075;2179
"6007";"melipilla";"18 a 19";1854;1756;3610
"6008";"alhué";"18 a 19";76;61;137
"6009";"curacaví";"18 a 19";462;432;894
"6010";"maría pinto";"18 a 19";191;182;373
"6011";"san pedro";"18 a 19";122;114;236
"6012";"talagante";"18 a 19";1136;1087;2223
"6013";"el monte";"18 a 19";528;521;1049
"6014";"isla de maipo";"18 a 19";549;525;1074
"6015";"padre hurtado";"18 a 19";937;912;1849
"6016";"peñaflor";"18 a 19";1386;1330;2716
"6017";"rancagua";"18 a 19";3444;3307;6751
"6018";"codegua";"18 a 19";181;184;365
"6019";"coinco";"18 a 19";104;102;206
"6020";"coltauco";"18 a 19";279;281;560
"6021";"doñihue";"18 a 19";295;292;587
"6022";"graneros";"18 a 19";498;462;960
"6023";"las cabras";"18 a 19";331;310;641
"6024";"machalí";"18 a 19";729;749;1478
"6025";"malloa";"18 a 19";195;166;361
"6026";"mostazal";"18 a 19";371;392;763
"6027";"olivar";"18 a 19";212;210;422
"6028";"peumo";"18 a 19";186;174;360
"6029";"pichidegua";"18 a 19";256;240;496
"6030";"quinta de tilcoco";"18 a 19";167;163;330
"6031";"rengo";"18 a 19";817;822;1639
"6032";"requínoa";"18 a 19";424;397;821
"6033";"san vicente";"18 a 19";632;588;1220
"6034";"pichilemu";"18 a 19";202;187;389
"6035";"la estrella";"18 a 19";33;27;60
"6036";"litueche";"18 a 19";71;71;142
"6037";"marchihue";"18 a 19";84;90;174
"6038";"navidad";"18 a 19";70;67;137
"6039";"paredones";"18 a 19";74;64;138
"6040";"san fernando";"18 a 19";1114;1013;2127
"6041";"chépica";"18 a 19";195;170;365
"6042";"chimbarongo";"18 a 19";518;466;984
"6043";"lolol";"18 a 19";89;81;170
"6044";"nancagua";"18 a 19";258;226;484
"6045";"palmilla";"18 a 19";149;153;302
"6046";"peralillo";"18 a 19";138;132;270
"6047";"placilla";"18 a 19";116;107;223
"6048";"pumanque";"18 a 19";36;46;82
"6049";"santa cruz";"18 a 19";493;493;986
"6050";"talca";"18 a 19";3431;3410;6841
"6051";"constitución";"18 a 19";655;616;1271
"6052";"curepto";"18 a 19";126;100;226
"6053";"empedrado";"18 a 19";56;49;105
"6054";"maule";"18 a 19";741;730;1471
"6055";"pelarco";"18 a 19";109;105;214
"6056";"pencahue";"18 a 19";116;110;226
"6057";"río claro";"18 a 19";173;177;350
"6058";"san clemente";"18 a 19";593;617;1210
"6059";"san rafael";"18 a 19";129;136;265
"6060";"cauquenes";"18 a 19";519;518;1037
"6061";"chanco";"18 a 19";102;107;209
"6062";"pelluhue";"18 a 19";83;70;153
"6063";"curicó";"18 a 19";2128;2010;4138
"6064";"hualañé";"18 a 19";126;117;243
"6065";"licantén";"18 a 19";83;76;159
"6066";"molina";"18 a 19";650;626;1276
"6067";"rauco";"18 a 19";143;139;282
"6068";"romeral";"18 a 19";214;186;400
"6069";"sagrada familia";"18 a 19";245;231;476
"6070";"teno";"18 a 19";394;380;774
"6071";"vichuquén";"18 a 19";43;39;82
"6072";"linares";"18 a 19";1366;1282;2648
"6073";"colbún";"18 a 19";284;285;569
"6074";"longaví";"18 a 19";396;368;764
"6075";"parral";"18 a 19";526;536;1062
"6076";"retiro";"18 a 19";266;231;497
"6077";"san javier";"18 a 19";678;632;1310
"6078";"villa alegre";"18 a 19";215;201;416
"6079";"yerbas buenas";"18 a 19";265;231;496
"6080";"concepción";"18 a 19";3560;3418;6978
"6081";"coronel";"18 a 19";1747;1652;3399
"6082";"chiguayante";"18 a 19";1313;1333;2646
"6083";"florida";"18 a 19";123;114;237
"6084";"hualqui";"18 a 19";358;352;710
"6085";"lota";"18 a 19";604;629;1233
"6086";"penco";"18 a 19";695;692;1387
"6087";"san pedro de la paz";"18 a 19";2008;1947;3955
"6088";"santa juana";"18 a 19";182;179;361
"6089";"talcahuano";"18 a 19";2457;2143;4600
"6090";"tomé";"18 a 19";780;724;1504
"6091";"hualpén";"18 a 19";1312;1276;2588
"6092";"lebu";"18 a 19";388;366;754
"6093";"arauco";"18 a 19";553;500;1053
"6094";"cañete";"18 a 19";491;472;963
"6095";"contulmo";"18 a 19";82;70;152
"6096";"curanilahue";"18 a 19";482;464;946
"6097";"los álamos";"18 a 19";301;305;606
"6098";"tirúa";"18 a 19";154;156;310
"6099";"los ángeles";"18 a 19";3010;2949;5959
"6100";"antuco";"18 a 19";57;53;110
"6101";"cabrero";"18 a 19";409;412;821
"6102";"laja";"18 a 19";338;322;660
"6103";"mulchén";"18 a 19";446;420;866
"6104";"nacimiento";"18 a 19";391;364;755
"6105";"negrete";"18 a 19";132;129;261
"6106";"quilaco";"18 a 19";56;41;97
"6107";"quilleco";"18 a 19";133;128;261
"6108";"san rosendo";"18 a 19";45;44;89
"6109";"santa bárbara";"18 a 19";190;190;380
"6110";"tucapel";"18 a 19";181;181;362
"6111";"yumbel";"18 a 19";278;269;547
"6112";"alto biobío";"18 a 19";70;84;154
"6113";"chillán *";"18 a 19";2834;2718;5552
"6114";"bulnes *";"18 a 19";292;296;588
"6115";"cobquecura *";"18 a 19";46;47;93
"6116";"coelemu *";"18 a 19";194;200;394
"6117";"coihueco *";"18 a 19";404;400;804
"6118";"chillán viejo *";"18 a 19";462;484;946
"6119";"el carmen *";"18 a 19";166;159;325
"6120";"ninhue *";"18 a 19";75;66;141
"6121";"ñiquén *";"18 a 19";136;138;274
"6122";"pemuco *";"18 a 19";133;129;262
"6123";"pinto *";"18 a 19";146;138;284
"6124";"portezuelo *";"18 a 19";63;66;129
"6125";"quillón *";"18 a 19";212;210;422
"6126";"quirihue *";"18 a 19";143;126;269
"6127";"ránquil *";"18 a 19";62;59;121
"6128";"san carlos *";"18 a 19";737;743;1480
"6129";"san fabián *";"18 a 19";64;44;108
"6130";"san ignacio *";"18 a 19";208;218;426
"6131";"san nicolás *";"18 a 19";171;154;325
"6132";"treguaco *";"18 a 19";75;60;135
"6133";"yungay *";"18 a 19";220;207;427
"6134";"temuco";"18 a 19";4512;4512;9024
"6135";"carahue";"18 a 19";378;343;721
"6136";"cunco";"18 a 19";240;234;474
"6137";"curarrehue";"18 a 19";108;102;210
"6138";"freire";"18 a 19";384;357;741
"6139";"galvarino";"18 a 19";162;152;314
"6140";"gorbea";"18 a 19";198;186;384
"6141";"lautaro";"18 a 19";587;561;1148
"6142";"loncoche";"18 a 19";352;317;669
"6143";"melipeuco";"18 a 19";78;71;149
"6144";"nueva imperial";"18 a 19";492;481;973
"6145";"padre las casas";"18 a 19";1217;1197;2414
"6146";"perquenco";"18 a 19";98;110;208
"6147";"pitrufquén";"18 a 19";356;346;702
"6148";"pucón";"18 a 19";394;384;778
"6149";"saavedra";"18 a 19";154;132;286
"6150";"teodoro schmidt";"18 a 19";162;165;327
"6151";"toltén";"18 a 19";139;120;259
"6152";"vilcún";"18 a 19";450;436;886
"6153";"villarrica";"18 a 19";818;790;1608
"6154";"cholchol";"18 a 19";201;194;395
"6155";"angol";"18 a 19";710;740;1450
"6156";"collipulli";"18 a 19";354;338;692
"6157";"curacautín";"18 a 19";230;230;460
"6158";"ercilla";"18 a 19";114;103;217
"6159";"lonquimay";"18 a 19";188;141;329
"6160";"los sauces";"18 a 19";112;98;210
"6161";"lumaco";"18 a 19";116;105;221
"6162";"purén";"18 a 19";145;137;282
"6163";"renaico";"18 a 19";143;133;276
"6164";"traiguén";"18 a 19";318;282;600
"6165";"victoria";"18 a 19";534;466;1000
"6166";"valdivia";"18 a 19";2620;2590;5210
"6167";"corral";"18 a 19";70;62;132
"6168";"lanco";"18 a 19";227;234;461
"6169";"los lagos";"18 a 19";284;261;545
"6170";"máfil";"18 a 19";86;92;178
"6171";"mariquina";"18 a 19";306;288;594
"6172";"paillaco";"18 a 19";314;298;612
"6173";"panguipulli";"18 a 19";529;497;1026
"6174";"la unión";"18 a 19";644;506;1150
"6175";"futrono";"18 a 19";200;201;401
"6176";"lago ranco";"18 a 19";127;111;238
"6177";"río bueno";"18 a 19";416;403;819
"6178";"puerto montt";"18 a 19";3794;3736;7530
"6179";"calbuco";"18 a 19";473;443;916
"6180";"cochamó";"18 a 19";34;34;68
"6181";"fresia";"18 a 19";169;161;330
"6182";"frutillar";"18 a 19";249;246;495
"6183";"los muermos";"18 a 19";228;221;449
"6184";"llanquihue";"18 a 19";260;260;520
"6185";"maullín";"18 a 19";180;161;341
"6186";"puerto varas";"18 a 19";662;591;1253
"6187";"castro";"18 a 19";620;578;1198
"6188";"ancud";"18 a 19";549;539;1088
"6189";"chonchi";"18 a 19";288;218;506
"6190";"curaco de vélez";"18 a 19";60;63;123
"6191";"dalcahue";"18 a 19";202;178;380
"6192";"puqueldón";"18 a 19";55;38;93
"6193";"queilén";"18 a 19";70;62;132
"6194";"quellón";"18 a 19";374;365;739
"6195";"quemchi";"18 a 19";89;101;190
"6196";"quinchao";"18 a 19";106;97;203
"6197";"osorno";"18 a 19";2296;2358;4654
"6198";"puerto octay";"18 a 19";136;120;256
"6199";"purranque";"18 a 19";289;281;570
"6200";"puyehue";"18 a 19";210;179;389
"6201";"río negro";"18 a 19";218;206;424
"6202";"san juan de la costa";"18 a 19";84;82;166
"6203";"san pablo";"18 a 19";134;132;266
"6204";"chaitén";"18 a 19";56;45;101
"6205";"futaleufú";"18 a 19";28;25;53
"6206";"hualaihué";"18 a 19";110;101;211
"6207";"palena";"18 a 19";18;19;37
"6208";"coyhaique";"18 a 19";991;850;1841
"6209";"lago verde";"18 a 19";8;4;12
"6210";"aysén";"18 a 19";384;256;640
"6211";"cisnes";"18 a 19";63;52;115
"6212";"guaitecas";"18 a 19";16;21;37
"6213";"cochrane";"18 a 19";57;40;97
"6214";"o'higgins";"18 a 19";1;2;3
"6215";"tortel";"18 a 19";2;3;5
"6216";"chile chico";"18 a 19";46;47;93
"6217";"río ibáñez";"18 a 19";24;16;40
"6218";"punta arenas";"18 a 19";2172;1717;3889
"6219";"laguna blanca";"18 a 19";2;2;4
"6220";"río verde";"18 a 19";3;1;4
"6221";"san gregorio";"18 a 19";2;3;5
"6222";"cabo de hornos";"18 a 19";16;18;34
"6223";"antártica";"18 a 19";0;0;0
"6224";"porvenir";"18 a 19";178;50;228
"6225";"primavera";"18 a 19";2;1;3
"6226";"timaukel";"18 a 19";3;0;3
"6227";"natales";"18 a 19";325;240;565
"6228";"torres del paine";"18 a 19";8;2;10
